ham - ветчину, ветчина, ветчиной, ветчины, окорок
garlic - чеснока, чеснок
atm - банкомат
what - что, то, что, какой, в каком, из какого, из чего, как, какая, какие, каким, каких, каков, какова, каково, каковы, какое, каком, какую, кого, кто, о чем, о чём, сколько, тем, чем, то, чего, чего, чем, что такое, чём
rare - редкие, задние, редкая, редких, задними, редкой
her - её, она, ей, ней, неё, о ней, с ней, свое, своего, своей, своем, своему, свои, своим, своими, своих, свой, свою, своя, своё, своём, у неё, у себя
movie - фильм, фильме, фильма, кино, фильму
nice - приятно, приятный, милы, добрая, доброе, доброй, добрый, мило, милые, милый, прекрасные, приятен, приятная, приятное, приятной, приятные, приятным, хорошо
playing - играть, играющих, играющую, занимаюсь, играет, играющая, играющий, игру, игры, поиграть
subway - метро
advice - совет, совета, советов, советы
beds - кроватей, кровати
still - ещё, всё ещё, до сих пор, всё же, всё равно, всё-таки, пока, спокойной, тихую
because - потому что, за то, что, из-за того что, так как
each - каждый, каждая, каждого, каждое, каждой, каждом, каждому, каждую
where - где, куда, (а) где, в котором, на котором, с чего, туда где
why - почему, зачем, из-за чего, по которой
living - живущих, живущая, живущие, живу, живут, живущий, живущую, живёт, жил, жить, как жить, проживающие
able - умеет, способна, способный, способен, способным, умеют
what - что, то, что, какой, в каком, из какого, из чего, как, какая, какие, каким, каких, каков, какова, каково, каковы, какое, каком, какую, кого, кто, о чем, о чём, сколько, тем, чем, то, чего, чего, чем, что такое, чём
future - будущий, будущую, будущая, будущее, будущей, будущем, будущему, будущие, будущим
green - зеленая, зелено, зеленого цвета, зеленое, зеленой, зеленом, зеленую, зелены, зеленые, зеленый, зеленым, зелеными, зелёно, зелёного, зелёным, зелёных
forty - сорок, сорока
cream - сливок, крем, сливки
balcony - балкон, балкона, балконе
without - без, не
lemonade - лимонада, лимонад
knows - знает, знает, что, знают, знают, что, узнает, узнает, что
twenty - двадцать, двадцати, 20, двадцатью, на двадцать
sixth - шестой, шестая, шестого, шестое, шестом, шестую
water - воду, воды, вода, воде, водой, поливайте, поливать, поливаю, полить
smarter - take - беру, берем, берешь, бери, берите, берут, брать, буду принимать, взял, взяла, взять, возьмем, возьмет, возьмешь, возьми, возьмите, возьмёшь, выезжай, делаешь, делать фотографии, едь, заберем, забирай, забрал, завезти, отвезти, отвезу, отвезут, отвожу, отвёз, отвёл, поверните, повернуть, поедем, поедешь, поезжай, приведу, прими, принимаете, принимайте, принимать, принимают, принять, садимся, садись, садись на, садиться, садишься, сдавать, сдашь, сделать, сесть, сесть на, снимать, съезжай, сядете, сядете на, сядьте
whom - кем, кого, кому, за кого, ком, которого, которой, которому, которую
whose - чья, чей, чьи, чью, чьё
put - положи, поставь, положил, включи, кладешь, клади, кладу, кладут, кладёшь, клал, клала, надела, надень, наденьте, наложить, положила, положили, положите, положить, положишь, положу, поставил, поставила, поставили, поставим, поставить, поставишь, поставлю, поставьте, сложи, ставил, ставила, ставить, ставлю, ставят, укрыл
meet - познакомиться, встретиться, встретила, встретил, встретили, встретились, встретим, встретимся, встретит, встретить, встретишь, встреться, встретятся, встретятся с, встречаем, встречаемся, встречаетесь, встречаешься, встречать, встречаю, встречают, встречаются, знакомитесь, знакомиться, знакомлюсь, познакомился, познакомитесь, познакомится, познакомится с
helping - помогает, помогаешь, помогаю, помогая, помочь
play - играть, играют, играю, заниматься, занимаюсь, играем, играет, играете, играешь, играешь на, играй, играйте, играл, играла, играли, играть в, играю в, играют в, поиграем, поиграет, поиграй, поиграть, проиграть, пьеса, пьесе, пьесой, пьесу, пьесы, спектакль, спектакля, сыграет, сыграй, сыграть
today - сегодня
dance - танцевать, танец, танцевальными, бал, балу, танца, танцуем, танцуете, танцую, танцуют
leaving - уходя, уходит, уезжают, оставалась, оставить, оставлять, покинуть, уезжаем, уезжаешь, уезжал, уезжаю, уйти, улетаем, улетает, улетаешь, улетают, уходил, уходим, уходить
busy - занят, занята, заняты, занятая, занятые, занятым, занятыми, напряженная, напряженное, напряженной, напряженные
nine - девять, девяти, девятого, девятью
five - пять, пяти, пятеро, 5, на пяти, от пяти, пять часов, пятью
or - или, ни
this - это, этот, эта, в этом, в этот, на этой, на этом, об этом, по этому, эти, этим, этого, этой, этом, эту
scarf - шарфом, шарф
grass - траве, трава, травой, газону, траву, травы
except - кроме, за исключением
jeans - джинсах, джинсов, джинсы, джинсам
potato - картофельные, картошка, картошки, картофельный, картошку, картофелину, картошкой
tired - устал, устала, устали, уставшая, уставшей, уставший, уставшим, усталость, усталым, утомлён
she - она, ей, её, ней, у неё
sister - сестра, сестры, сестре, сестрой, сестру
weaker - слабее
bed - кровати, кровать, кроватью, кроватей, кроватку, кроватью, которую, постели
they - они, её, им, их, она, у них
cupcakes - пирожные, пирожных
pasta - макароны, паста, пасте, пасту
why - почему, зачем, из-за чего, по которой
shirt - рубашка, рубашку, рубашке, рубашки
black - в черном цвете, черная, черной, черную, черные, черный, чёрного, чёрное, чёрным, чёрными, чёрных
very - очень
fun - весело, веселые, весёлая, весёлой, весёлый, весёлым, весёлых, забавно, забавные, забавный
favorite - любимый, любимая, любимое, любимой, любимом, любимую, любимые, любимым, любимыми, любимых
dresses - платья, платьев, платьями, одевает
milk - молоко, молока, молоком, молоке, молочные, молочный
divorced - разведены, разведён, в разводе, разведена, развелись
yours - твоя, твой, ваши, ваш, ваша, ваше, свою, твое, твоего, твоей, твои, твоим, твою, твоё
marry - замуж, выйти замуж, выходи за меня замуж, выйдет замуж, женись, женись на мне, женится, жениться
theirs - их, свой, своей
ours - наши, наша, наше, наш, нашего, нашей, нашими, нашу
mine - моя, мой, мои, моего, моей, моим, моих, мою, моё, моём, свою
hers - её, своё
must - должен, должны, обязаны, должна, обязан, обязана
may - могу, май, можешь, возможно, мае, маем, мая, могут, можем, может, можете, можно
cooking - готовить, кулинарный, готовила, готовим, готовит, готовите, готовишь, готовка, кулинария, приготовление
does - делает, занимается, в, поступает, у, –
so - так, так что, так и, итак, настолько, потому, поэтому, столько, такая, такие, таким, такими, такое, такой, такой уж, то есть, чтобы
dancing - танцующим, танцев, потанцевать, танцы, танцуют, танцевал, танцевать
drawing - рисует, рисунок, рисующая, рисовать, рисуешь, рисую, рисуют, рисующий, рисующих, рисующую, что рисовала
do - делать, сделать, занимаешься, делаем, делает, делаете, делаешь, делай, делайте, делал, делала, делали, делаю, делают, занимаемся, занимайся, занимался, занимаюсь, сделаем, сделаешь, сделай, сделайте, сделал, сделали, сделаю, сделают, собираем, у тебя, —
do - делать, сделать, занимаешься, делаем, делает, делаете, делаешь, делай, делайте, делал, делала, делали, делаю, делают, занимаемся, занимайся, занимался, занимаюсь, сделаем, сделаешь, сделай, сделайте, сделал, сделали, сделаю, сделают, собираем, у тебя, —
crying - плакать, плачет, плач, плачут, плачущими, плачешь
anything - ничего, ничего (при отрицании), что-нибудь, всё, нечего, чем-нибудь, что угодно, что-либо, что-нибудь (в вопросах)
does - делает, занимается, в, поступает, у, –
seldom - редко
might - может, возможно, мог бы, могут, может и, можете, можешь
equals - равняется, равно, равен, равна
zero - нуль, нуля, нулю, нолю, ноль, нулевой
times - раз, раза, умножить на, времена
fly - муха, летать, летают, летаем, летаете, летаешь, летал, летало, летаю, летим, летишь, летят, лечу, мухи, полететь, полетишь, полечу, прилететь, прилечу, управлять, управляют
and - и, а, с, в, да, до
more - больше, ещё, более, большего, больший, дольше, побольше
goes - ходит, идёт, едет, ездит, идет, идут, пойдет
minus - минус
all - все, всё, всех, весь, всего, всем, всеми, всему, всю, вся, всякая, всё что, совершенно, у всех, целый
plus - плюс
these - эти, это, этих, те, эта, этим, этими, этой, этот, эту
interesting - интересная, интересный, интересно, интересен, интересна, интересного, интересное, интересной, интересному, интересную, интересны, интересные, интересным, интересными, интересных
very - очень
than - чем
this - это, этот, эта, в этом, в этот, на этой, на этом, об этом, по этому, эти, этим, этого, этой, этом, эту
flies - мухи, летает, летит, мух, мухам, управляет
small - маленькие, маленькая, маленький, магазином, мал, маленьким, маленькими, маленьких, маленького, маленькое, маленькой, маленьком, маленькому, маленькую, мало, малы, мелкие, мелких, небольшая, небольшим, небольшое, небольшой, небольшом
yes - да
them - их, им, них, его, её, ими, на них, ними, они, с ними, у них
was - был, было, была, бывало, были, находится, стоила, стояла, это
mice - мыши, мышей, мышами, мыши (множеств. число)
orange - апельсин, оранжевая, апельсинового, апельсина, апельсиновый, оранжевые, оранжевый, оранжевых
his - его, свою, своей, по своему, по своим, свое, своего, своем, своему, свои, своим, своими, своих, свой, своё, своём, у него
trusts - доверяет
well - хорошо, известны, колодец, ну
their - их, своих, свою, своего, своей, свои, своим, своими, свой, своя, своё
respect - уважение, уважаем, уважаю, уважает, уважаете, уважаешь, уважать, уважают, уважением
these - эти, это, этих, те, эта, этим, этими, этой, этот, эту
eggs - яйца, яиц, яйцами
are - (есть), есть, находятся, будут, бывает, бываете, бываешь, входят, лежат, находимся, находишься, сидят, стоят, это, являешься, являются, —
loves - любит, обожает, любят, нравятся, обожают
remembers - помнит, вспоминает, не забывает
her - её, она, ей, ней, неё, о ней, с ней, свое, своего, своей, своем, своему, свои, своим, своими, своих, свой, свою, своя, своё, своём, у неё, у себя
had - был, имели, имело, бывало, была, были, было, выпил, ел, ела, есть, имел, имела, появились, появился, съела, съели, у нас, у нас был
trust - доверяю, доверяем, доверяешь, (!) доверься, (!) поверь, доверяет, доверяете, доверять, доверяют
see - вижу, видим, видеть, видел, видели, видеться, видит, видите, видишь, видят, встретимся, обратись, обратись к, обратиться, обратиться к, обращаешься, обращусь, посмотрим, посмотрите, смотреть, смотри, смотрите, увидел, увидели, увидеть, увидеться, увидим, увидит, увидите, увидишь, увидишься, увидят, увижу
little - мало, маленькая, маленький, маленькие, маленьким, маленькими, маленьких, маленького, маленькое, маленькой, маленьком, маленькую, младшая, младшей, младшие, младший, небольшой
tomatoes - помидоры, помидора, помидорами, помидоров, томатов, томаты
sees - видит, увидит
mouse - мышь, мышью, мыши, мышку
cold - холодно, холодный, холодная, в холоде, простуда, простуды, холоден, холодного, холодное, холодной, холодные, холодным, холоду
fish - рыбу, рыба, рыбы, рыб, рыбами, рыбе, рыбий, рыбкой, рыбный, рыбой, рыболовный
women - женщины, женщин, женщинам, женщинами, женщинах
to - в, на, с, -, во, для, до, за, к, ко, по, со, чтобы
too - слишком, тоже, и
fruit - фрукты, фрукт, ни фрукты, плод, плодами, фрукта, фруктами, фрукте, фруктов, фруктового, фруктовые, фруктовый, фруктом
us - нас, нам, нами, американская, американской, к нам, мы
be - быть, будьте, будет, будешь, будут, будь, оказаться, стать, являться
know - знаю, знаешь, знать, Знай!, Знайте!, знаем, знает, знаете, знай, знаком, знали, знают, знают, что, известно, узнаем, узнать
ok - хорошо, OK, в порядке, ладно, нормальная, нормально, нормальные, нормальный, нормальным
actresses - актрисы, актрис
toy - игрушка, игрушку, игрушечная, игрушечного, игрушечную, игрушечные, игрушечный, игрушечных, игрушкой
rugby - регби
national - национального, национальная, национальную, национальное, национальной, национальному, национальные, национальный, общенациональную, общенациональные
the most - наиболее, самыми, самом, с самыми, больше всего, самое, самая, самые, самого, самый, самым
nothing - ничего, нечего, ничто, ничто ... не
hollywood - Голливуд, Голливуде
the us - Соединённых Штатах, Соединёнными Штатами, Соединённые Штаты, Соединённых Штатов
like - нравится, люблю, любят, как, как и, любил, любила, любим, любит, любите, любишь, например, нравилась, нравилось, нравятся, понравился, понравится, похож на, похожи на
white house - average - средняя, средний, среднем, обычный, среднего, среднее, среднестатистические, среднестатистический, среднестатистических, средним
is it ok to - можно
middle - середине, середину, середина
happy to - ok - хорошо, OK, в порядке, ладно, нормальная, нормально, нормальные, нормальный, нормальным
cool - круто, классная, классное, классной, классном, классную, классные, классный, классным, классными, классных, прохладной, прохладные, прохладный, прохладным
grand canyon - eighth - восьмой, восьмого, восьмое, восьмом
seventh - седьмой, седьмое, седьмого, седьмом
easier - легче
Easter - Пасха, Пасху, tenth - десятом, десятое, десятая, десятого, десятой, десятую, десятый, десятым
lucky - везучий, счастливую, счастливых, везучие, везучими, удачливые, счастливые, счастливый, везучая, счастливой
smile - улыбка, улыбаетесь, улыбайся, улыбаться, улыбаюсь, улыбаются, улыбкой, улыбку, улыбнуться
during - во время, в течение, в, за время, на, посреди
sweet - сладкий, сладко, сладкая, милая, милую, милый, милым, нежный, приятный, сладкие, сладких, сладкого, сладкое, сладкую, сладок
worse - хуже
teeth - зубы, зубов, зуба, зубами, зубах
men - мужчины, мужчин, людей, люди, мужчинам, мужчинами, человек, человека
world - мир, мире, мира, мировая, мировой, миру
glass of - soda - газировки, газировка, газировку
if - если, ли, если бы, когда
chess - шахматы, в шахматы, шахматами, шахматах
salt - соль, соли, солью
trash - мусор, мусорные, мусоре, мусора, мусорный, мусором
best - лучший, лучшие, лучшим, больше всего, лучшая, лучше всего, лучшего, лучшей, лучшему, лучших, лучшую, наилучшие, наилучший, самая лучшая, самый лучший
pepper - перца, перец, перцем
cat - кошка, кот, кошки, кота, котом, коту, кошке, кошкой, кошку
guess what - представь
anywhere - где-нибудь, где угодно, где, где-то, куда угодно, нигде, никуда
walking - гуляя, гуляет, идти, гуляешь, гуляли, гулять, идёт, прохожу, ходить, ходьба, ходьбу
air - воздуха, воздухе, воздух, воздухом, воздушного
anyway - всё равно, в любом случае
up - наверх, вверх, громче
such as - better - лучше, больше, лучший, получше
ping pong - настольный теннис
spare time - fast food - фастфуд
sleeping - спать, сна, спишь, поспать, сон, спанья, спим, спит, сплю, спят, спящую
change of clothes - сменная одежда, сменную одежду
lunchtime - обеденный перерыв, обеденного перерыва
is - находится, есть, является, будет, будут, в, ему, лежит, равняется, составляет, состоится, стоит, учится, это, является ли (?), —
the - will not - не будет, не, будет
your - твой, твоя, твои, ваш, ваша, ваше, вашего, вашей, вашем, вашему, ваши, вашим, вашими, ваших, вашу, на твоем, свое, своего, своей, своем, своему, свои, своим, своими, своих, свой, свою, своя, со своим, со своими, твое, твоего, твоей, твоем, твоему, твоим, твоими, твоих, твою, у вас, у твоего, у твоей, у тебя
you'll - тебе, ты, вы, будешь, ты будешь
news - новости, новость, новостная, новостей, новостные, новостями
ticket - билет, билета, билете, по продаже билетов
i - я, мне, меня, у меня
but - но, а, зато, за исключением, кроме, помимо
on time - вовремя
good - хорошая, хороший, хорошо, доброе, доброй, добрый, подходящее, подходящий, полезен, полезно, полезны, полезный, правильное, хорош, хороша, хорошего, хорошее, хорошей, хорошем, хороши, хорошие, хорошим, хорошими, хороших, хорошую
fourth - четвёртый, четвёртого, четвертого, четвертое, четвертом, четвёртая
important - важно, важный, важная, большое, важен, важна, важного, важное, важной, важную, важны, важные, важным, важными, важных
a - get hungry - проголодаешься, проголодаюсь, проголодаются
because - потому что, за то, что, из-за того что, так как
quickly - быстро
a lot - много, гораздо, многое, сильно, очень
sorry - извини, извините, жаль, жалко, прости, простите
worked - работал, работала, работали, проработали
we - мы, нам, когда мы, нужна, у нас
after - после, за, после  того, как, спустя
hard - трудно, трудная, тяжело, жестка, жесткая, жесткие, жесткий, жесткой, жестком, пнуть, сильно, сложно, сложный, твёрдая, твёрдый, трудного, трудное, трудной, трудные, трудный, трудным, трудных, тяжела, тяжёлого, усердно, усердные, усердный
let's - давайте, давай, пусть
boss - начальник, начальника, начальником, босс, босса, боссе, боссом, боссу
we'll - мы, мы будем
get - получить, получать, добраться, будете садиться, взять, возьмем, встаньте, доберемся, доберетесь, доберешься, доберусь, заберут, забрать, купим, получаем, получает, получал, получаю, получают, получил, получила, получим, получит, получите, получишь, получу, принимаю, раздобыть, садиться, сделать (получить), сесть, становятся, съедим, съесть, сядем
vegetarian - вегетарианец, вегетарианцы, вегетарианка, вегетарианские, вегетарианский, вегетарианским, вегетерианские, вегетерианский, вегетерианскую
tonight - сегодня вечером, сегодня ночью, сегодняшнего, сегодняшнего вечера, сегодняшний вечер
sorry - извини, извините, жаль, жалко, прости, простите
with me - в меня, с собой, мной, со мной
volleyball - волейбол, волейболом, волейболе
dressed - одевшись, одевалась, одевал, одевала, одел, оделся, одет, одета, одеты
carefully - аккуратно, осторожно, внимательно
toothpaste - зубная паста, зубную пасту, зубной пасты
several - несколько, нескольким, нескольких
with her - с собой
in the beginning - вначале
with him - с собой, с ним
student - студент, студентка, ученик, студента, студенткой, студентку, студентом, студенту, ученика, ученикам, ученике, учеником, ученику, ученица, ученицей, ученицу, ученицы
greece - Греции, Грецию, Греция
family - семья, семьи, семье, семейное, семейный, семейным, семьей, семью
check - проверку, проверьте, чек, поставили галочку, проверим, проверит, проверить, проверишь, проверь, проверяешь, проверяю, сдавать, счет, счета, чеком
menu - меню
beef - говядину, говядина, говядины
he - он, ему, его, него
egg - яйцо, яйца, яйцом
rarely - редко
bagel - бублик
scarves - шарфа, шарфов, шарфы
not - не, нет, а не, не будем, ни
daughter - дочь, дочери, дочка, дочерью
knives - ножи, ножей, ножа
white - белая, белый, белые, бел, бело, белого, белое, белой, белом, белую, белым, белыми, белых, бумага
egypt - Египта, Египет, Египте
her - её, она, ей, ней, неё, о ней, с ней, свое, своего, своей, своем, своему, свои, своим, своими, своих, свой, свою, своя, своё, своём, у неё, у себя
first - первый, сначала, первая, первого, первое, первой, первом, первую, первые, первым, первыми, первых, сперва
ninth - девятое, девятый, девятая, девятой, девятом, девятым
sky - небе, небо
rice - рис, риса, рисом, рисовой
immediately - сразу же
a - it's time for bed - golden - золотой, золотая, золотое, золотом, золотые, золотым, золотых
as soon as possible - как можно скорее
one day - однажды
into - в, во, на
once - один раз, однажды, раз
magic - волшебной, магии, волшебными, волшебная, магию, магия, волшебный, волшебном, волшебное, волшебные
fought - сразился, сразился с
hundreds - сотни, сотнями
red hair - рыжие волосы
only - только, лишь, всего лишь, единственную, единственный, единственным, просто
australian - австралийка, австралиец, австралийская, австралийский, австралийским, австралийцы, австралийские
sand - песок, песка, песке
awesome - обалденные, обалденная, обалденный
fog - туман, тумана, тумане
New Zealand - Новой Зеландии, Новую Зеландию, Новая Зеландия, зеландия
first - первый, сначала, первая, первого, первое, первой, первом, первую, первые, первым, первыми, первых, сперва
air conditioning - кондиционер, кондиционера
кондиционером
australia - Австралии, Австралию, Австралия
said - сказал, сказала, говорила, говорил, говорили, сказал, что, сказала, что, сказали
wrong - неправильно, неправильный, неверный, не так, неверен, неверна, неверно, неверной, неверные, неправ, неправа, неправильная, неправильное, неправильной, неправильном, неправильному, неправильные, неправы, по неправильной
climbing - under - под, подо, при, до, меньше
classical - классической, классическую, классическая, классические, классический
all - все, всё, всех, весь, всего, всем, всеми, всему, всю, вся, всякая, всё что, совершенно, у всех, целый
sydney - Сиднеем, Сиднее
surfing - заняться сёрфингом
заниматься сёрфингом
visiting - навещу, навестит, посетить, навестим, навещал, посещать
come on - да ладно
by yourself - самостоятельно
yourself - сам, себя, сам себе, сама, сама себе, сами себе, самому, себе, собой
since then - с тех пор
benefits - польза, выгоды, социальный пакет
daily - ежедневно, ежедневная, ежедневные, ежедневное, ежедневный, повседневной
by himself - сам, самостоятельно, один
bad at - studies - учится, занятия, изучает, занимается, занимался, обучение, учебу, учёбу
by myself - самостоятельно
working - работает, работаю, работать, работаем, работаете, работал, работала, работающим, работу, работы
history - истории, история, историю, историей, ни историю
certainly - безусловно, точно, разумеется
science - наука, науки, научной, естественные науки, естественных науках, науке, наукой, науку, научная
advanced - продвинутом
salesperson - продавец, продавца, продавцу
i'd like - я бы хотела, я бы хотел
one - один, одна, одно, одним, одного, одной, одну
soap - мыло, мыла, мылом, мыльными
pleased - доволен
ones - shorts - шортах
шорты, salespeople - продавцами, продавцы
various - разнообразные, разными
различные, разнообразных
carpet - ковёр, ковре, ковра, ковровое покрытие, ковровым покрытием, ковром
opposite - противоположная, противоположны, противоположный, напротив, противоположность
on foot - пешком
wooden - деревянный, деревянная, деревянной, деревянном, деревянную, деревянные, деревянным, деревянными, деревянных
downstairs - внизу
fashion - моды, мода, моду, моде
shelves - полки, полок
the front of - electric - электрический, электрические, электрическая, электрической
butter - масло, масла, маслом, сливочного масла, сливочное масло, сливочным маслом
and - и, а, с, в, да, до
yes - да
no - нет, не, никакого, без, нету, никаких, никакой, ноль
tea - чай, чая, чаю, чае, чаем, чайной, чайных
please - пожалуйста
bread - хлеб, хлеба, хлебом, хлебу
goodbye - до свидания
thank you - спасибо, благодарю
coffee - кофе
thanks - спасибо, благодарит, благодарю
august - августе, август, августом, августа
dinner - ужин, ужина, ужине, ужином, ужину
april - апрель, апреле, апреля
children - дети, детей, детям, детьми, детях, ребёнка
coat - пальто, плащ, плаще, куртка
turkey - индейки, индейка, Турция, Турцию, в Турцию, индейку
june - июня, июнь
music - музыку, музыка, музыки, музыкальный, музыкальными, музыкальных, музыке, музыкой
it's - это, она, её, здесь, он, они, оно, оно будет, сегодня, сейчас
phone - телефон, телефона, звонит, телефоне, телефонная, телефонного, телефонные, телефонный, телефонным, телефонных, телефоном
don't - не, нет
hung up - повесила трубку, повесил трубку
friends' - back - назад, спины, спина, задней, заднем, заднюю, обратно, обратной стороне, обратную сторону, спине, спинные, спиной, спину
aren't - не будешь, не, разве не
isn't - разве, не
speak to - поговорить с
what's up - как дела, что случилось, как ты, как вы, these days - в наши дни, в последнее время, в эти дни
parents' - родителей
available - доступен, доступны, доступные, доступна, доступно, доступный, свободен, свободна
speaking - говорит, говорить, говорящая, говоришь, говорящего, говорящую, разговариваем, разговаривает, разговорном, у телефона
correct - верно, правильно, правильный, верен, прав, права, правда, правильного, правильные
doesn't - разве, не, нет
rang - звонил, зазвонил, звонила
hold on - подождать, подождите, подожди
can i have - Можно мне, можно
excellent - отличное, отличная, отличные, Отлично!, замечательное, замечательные, замечательный, отлична, отличном, отличный, отличным, превосходная, превосходны, превосходные, превосходный
of the day - дня
hot chocolate - горячий шоколад
roast - печь, запеченную, запечь, запечённое, запеченной, запекают, запеченные, запечем, жареное
it's on me - я заплачу
grilled - жарил, пожарили
after that - looked - посмотрела, посмотрел, посмотрели, был похож, выглядел, выглядела, выглядели, выглядело, искала, смотрел, смотрели
taken off - взлетели
a bit - чуть-чуть, слегка, немного, немножко
boarding - посадка
посадку, посадки, 's - есть
packed - упаковала, упаковал
he's - он будет, ему будет, это, он
it's time - будет пора, пора
whole - весь, целый, всю, всей, всему, вся, всё, всём, цел, целую
lost - потерял, потеряла, проиграли, потерялась, потеряли, потерялись, потерялся, проиграл, проиграла, терял
forgotten - забыта, забыла, забыт, забыл, забыли, забыто, забытый
forgot - забыл, забыла, забыли
yeah - да, ну да
alright - цел, ладно
she's - ей, она
as usual - for a long time - очень долго, долго, давно
that - что, это, то, в котором, в том, кому, которая, которого, которое, которой, котором, которую, которые, который, которым, которых, на котором, на которых, на тот, с которым, та, так, так уж, такими уж, такого, такой, те, тем, того, той, том, тому, тот, ту, чего, чтобы, эта, этим, этого, этой, этом, этот, эту
how much - почём, сколько
valuable - ценная, ценные, ценно, ценный, ценен
scissors - ножницы, ножниц, ножницами
for sale - продается, продаются
sure - уверена, уверен, уверены, конечно, точно, уверен, что, уверена, что, уверенным, уверены, что
hers - её, своё
vintage - старинную, старинным, старинный, старинная, старинные, старинное
already - уже
still - ещё, всё ещё, до сих пор, всё же, всё равно, всё-таки, пока, спокойной, тихую
bought - купил, купила, купили, куплен, куплена, покупал, покупала, покупали
do - делать, сделать, занимаешься, делаем, делает, делаете, делаешь, делай, делайте, делал, делала, делали, делаю, делают, занимаемся, занимайся, занимался, занимаюсь, сделаем, сделаешь, сделай, сделайте, сделал, сделали, сделаю, сделают, собираем, у тебя, —
cool - круто, классная, классное, классной, классном, классную, классные, классный, классным, классными, классных, прохладной, прохладные, прохладный, прохладным
found - нашёл, нашла, нашли, найден, найдены, находили, нашел, обнаружил, обнаружила, обнаружили, открыл, открыли
will - будет, буду, будут, (намерение), будем, будете, будешь, будут ли
great - великий, отличный, большие, большое, большой, великая, великие, великим, великих, великолепный, великом, замечательно, замечательный, огромная, огромное, огромный, отличная, отлично, отличное, отличной, отличную, отличные, отличным, отличных, с большим, хороши
gave - дал, дала, подарил, давал, давала, давали, дали, отдал, подарила, произнёс, сообщал, указал
dress - платье, платья, платью, одеваемся, одеваешься, одевалась, одеваюсь, платьем
high - высокая, большая, высокие, высокий, высоким, высоких, высоко, высокое, высокой, высокую
somebody - кого-то, кто-то, кем-то, кого-нибудь, чей-то
christmas - рождества, рождество
needed - нужна была, нужен, нужен был, было нужно, нужно, нужно было, нужны были
oh - ох, ой, о
really - действительно, неужели, очень, правда, совсем, точно
how much - почём, сколько
old - старый, старая, старые, -, - (про возраст), -- (про возраст), бывшего, бывшему, бывшие, бывшим, стар, стара, старого, старое, старой, старом, старую, старым, старыми, старых
does - делает, занимается, в, поступает, у, –
want - хочу, хочешь, хотят, захотеть, захотим, захотят, захочет, захочешь, захочу, хотел, хотела, хотели, хотеть, хотим, хотите, хотят, чтобы, хочет, хочется
surprised - удивлены, удивлен, удивлена
furniture - мебели, мебель
i'll - я буду, я
something - что-то, что-нибудь, кое-что, нечто, чего-нибудь, чем-то, чём-то
poster - плакат
break - каникулы, каникул, разобьёшь, ломается, ломаю, нарушают, нарушить, перерыв, перерыва, разбейте, разобьет, разобьешь, сломал, сломались, сломать, сломаться
alarm clock - будильник
chairs - стулья, стула, стульев, стульями
do you have - есть, у тебя, у вас, у вас есть, (?) у тебя есть, у тебя есть, (?) у вас есть
's - есть
in - в, через, во, в том, чтобы, за, на
would you like - вы бы хотели, ты хотел бы, ты хочешь, ты бы хотел, ты бы хотела
crowded - переполнена, переполненных, переполнен, переполненными, переполнено, переполненный, переполненная, переполнены, переполненное
it's - это, она, её, здесь, он, они, оно, оно будет, сегодня, сейчас
too - слишком, тоже, и
works - работает, работы, работ, работами
their - их, своих, свою, своего, своей, свои, своим, своими, свой, своя, своё
they're - они
она, all - все, всё, всех, весь, всего, всем, всеми, всему, всю, вся, всякая, всё что, совершенно, у всех, целый
wanted - хотел, хотели, хотела, захотел, захотела, хотел, чтобы, хотело, хочешь
always - всегда, постоянно
table - стол, столе, столом, стола, столик, столовые, столом, который, столу
oh my gosh - боже
to buy - покупать, покупала, купила, покупали, купил, чтобы покупала, купить, чтобы покупал, покупал, чтобы покупали
people - люди, людей, человек, людьми, людям, людях, народу, человека
money - деньги, денег, деньгами, деньгах
garage sale - гаражной распродаже, гаражную распродажу
sidewalk - тротуар, тротуаре
why don't - почему бы
help - помочь, помогать, помощь, помог, помогает, помогаешь, помогала, помогаю, помогают, помоги, помогите, помогла, помогу, помогут, поможем, поможет, поможешь, помощи, помощью
needs - нужно, нужна, надо, нуждается, нуждаться, нужен, нужны
with - с, со, у, в, вместе, из, при, –
going - собираюсь, собирается, будет, едем, едет, едете, едешь, еду, едут, ездить, ехать, идем, идет, идти, иду, идут, идём, идёт, идёте, идёшь, поеду, пойдем, пойду, собираетесь, собирается ли, ходить
to read - читать, прочитал, почитать, прочитали, прочитать
europe - Европе, Европу, Европа, Европы
bring - принести, принеси, принесла, взять, заведи, занеси, приведет, приведешь, приведите, приведу, привезем, привези, привезти, привел, привести, приводи, приводить, приводят, принесем, принесет, принесите, принесу, принесёшь, приносить, приносишь, приносят, приношу
together - вместе, вдвоём, друг с другом
if you like - west - западе, запад, западном, западный, западным, на запад
we're - мы, мы будем
me - мне, меня, я, за мной, мной, мною, по мне, себя
every - каждый, каждое, каждую, каждая, каждого, каждой, каждом, каждому, каждые, каждым, у каждой
directions - маршрут, указания
luggage - багаж, багажа, багажом
when - когда
on the plane - в самолете
key - ключ, клавиша, ключа, клавишу, ключом
before bed - перед сном
of - в, из, о, за, об, обо, от, со, у, –
breakfast - завтрак, завтрака, завтраком
lunch - обед, обедом, обеда
first of all - в первую очередь, во-первых
next - следующий, следующей, следующем, будущий, дальше, следующая, следующего, следующее, следующие, следующим, следующих, следующую, соседней, соседнем, соседний
gift shop - магазин подарков
two - два, две, двух, 2, второго, втором, два часа, двое, двоих, двум, двумя, на две, от двух
hurts - болит, будет болеть
where - где, куда, (а) где, в котором, на котором, с чего, туда где
our - наш, наша, наши, на нашей, наше, нашего, нашей, нашем, нашему, нашим, нашими, наших, нашу, ни наши, своего, своей, свои, своими, своих, свой, свою, своя, своё, у нашего
how about - как насчёт того, чтобы, как насчёт, как насчет
parking - парковка, парковку
back - назад, спины, спина, задней, заднем, заднюю, обратно, обратной стороне, обратную сторону, спине, спинные, спиной, спину
swimming pool - бассейном, бассейне, бассейн, бассейна, плавательный бассейн
some - некоторые, немного, какую-нибудь, -, какая-то, какие-то, какими-то, каких-нибудь, какого-нибудь, какого-то, какое-то, какой-нибудь, какой-то, какому-то, какую-то, кое-какие, некоторое, некоторым, некоторыми, некоторых, несколько, чуть-чуть
guest - гость, гостевая, гостевой, гостья, постояльцу
receptionist - администратору, администратор
guests - гости, гостей, гостями, постояльцев, постояльцы
has - есть, у него, имеет, -, в, владеет, владеть, ест, иметь, нет, обладает, у, устраивает
last - прошлом, прошлой, в прошлый, в последний раз, в прошлом, в прошлую, на прошлую, последнее, последней, последнем, последние, последний, последнюю, последняя, прошлая, прошлого, прошлое, прошлому, прошлую, прошлые, прошлый, прошлым
last night - вчерашнего вечера, вчера вечером, прошлая ночь, прошлый вечер, вчера ночью, прошлой ночью
all about - right - направо, прямо, права, верно, верном, верные, всё верно, да, прав, правая, правда, правильно, правильное, правильной, правильном, правильный, право, правое, правой, правом, правую, правы, справа, так
wife - жена, жены, жене, женой, жену
weren't - не были, не была, не был, не было
saw - видел, увидел, видели, видела, обратился, обратился к, посмотрел, посмотрела, посмотрели, проводил, увидела, увидели, увиделся
jewelry - драгоценности
soon - скоро, скорого, вскоре, поскорее, скорее
saturday - субботу, суббота, субботой, субботе, субботы
his - его, свою, своей, по своему, по своим, свое, своего, своем, своему, свои, своим, своими, своих, свой, своё, своём, у него
cricket - крикет
looking at - that - что, это, то, в котором, в том, кому, которая, которого, которое, которой, котором, которую, которые, который, которым, которых, на котором, на которых, на тот, с которым, та, так, так уж, такими уж, такого, такой, те, тем, того, той, том, тому, тот, ту, чего, чтобы, эта, этим, этого, этой, этом, этот, эту
yesterday - вчера
an - -
him - ему, его, ним, им, к нему, него, нём, он, с ним, себя, у него
working - работает, работаю, работать, работаем, работаете, работал, работала, работающим, работу, работы
here is - вот
much - много, гораздо, намного, сильно
not bad - ничего, неплохая, неплохие, неплохой
yuck - фу
here - здесь, тут, сюда, вот, вот же
don't have to - не обязаны, не должны
local - местные, местная, местную, местное, местной, местном, местный, местными, местных
another - другой, ещё, другом, другая, другим, другого, другое, другую, еще один, ещё один, ещё одна, ещё одно, ещё одного, ещё одной, ещё одну
food - еду, еда, еды, еде, едой, корм, корма, пища, пище, пищи, пищу
noon - полдень, полудню, полудня
seven - семь, семи, семью, седьмом, семеро
left - налево, левой, осталось, вышедших, вышел, вышли, забыл, забыла, левая, левого, левое, левом, левую, левые, левый, оставил, оставила, оставили, оставлена, оставленным, осталась, остался, покинул, покинула, покинули, уехал, уехала, уехали, улетал, улетел, улетела, ушел, ушла, ушли, ушёл
monday - понедельник, понедельнику, понедельника
midnight - полночь, полуночи
strange - странный, странное, странные, странная, странно, странной, странную, странным, странными, странных
hair - волосы, волос, волосами, волосах
this morning - сегодня утром, утром
husband - муж, мужа, мужу, муже, мужем
them - их, им, них, его, её, ими, на них, ними, они, с ними, у них
cats - кошки, кошек, кошками, котов, коты, кошкам
i'm - мне, я буду, я
as - как, как и, так, в качестве, в то время как, где и, как (качество), насколько, настолько, пока, столь же, так же, так как, такая же, такие, таким, такими же, такое же, такой, такой же, что, что и
careful - внимательны, аккуратна, аккуратно, аккуратны, аккуратный, аккуратным, внимателен, внимательна, осторожен, осторожна, осторожно, осторожны, осторожный, осторожным, осторожными
ten - десять, десяти, 10, в десяти, десятого, десятом, от десяти
tuesday - вторник, во вторник, вторника
sleeping - спать, сна, спишь, поспать, сон, спанья, спим, спит, сплю, спят, спящую
afraid - страшно, боится, бойся, испуган, испуганный
three - три, трёх, трое, тремя, третьем, трех, три часа, троих, трём
grandchildren - внуки
office - офис, офиса, офисе, офисом, офису, работа (место)
friendly - дружелюбен, дружелюбными, дружелюбная, дружелюбные, дружелюбна, дружелюбной, дружелюбным, дружелюбное, дружелюбный
hurrying - торопилась
east - востоке, восток, восточной, восточном, западный, на восток
eat - едят, ем, есть, едим, едите, ел, ела, ели, ест, ешь, ешьте, кушать, питается, питаются, поедим, поем, поесть, поешь, съедают, съедим, съедят, съем, съесть, съешь
bad - плохой, плохая, плохие, вредная, вредно, вредны, плох, плоха, плохим, плохими, плохих, плохо, плохое, плохом, плохому, плохую, слаб, слаба
bathroom - туалет, ванная, туалете, ванной, ванной комнаты, ванную, туалетом
of course - конечно
read - читаю, читать, читают, почитай, прочесть, прочитаем, прочитай, прочитайте, прочитал, прочитала, прочитали, прочитать, прочитываем, прочитываешь, прочитывают, прочла, прочти, прочёл, читаем, читает, читаете, читаешь, читай, читайте, читал, читала, читали
reads - читает, прочитывает, читать
driving - ездить, ведем машину, ведешь машину, веду машину, водите, водительское, вождение, вождения, поеду, поеду на машине
gas station - заправки, автозаправочной станции, автозаправке, заправка, заправке, бензоколонке
comic - комикс
sunday - воскресенье, в воскресенье, воскресенью, воскресенья
groceries - продукты, продуктов
attractive - привлекательный, привлекательную, привлекательная
than - чем
evening - вечер, вечером, вечера
man - мужчина, человек, человека, мужчине, мужчиной, мужчину, мужчины, человеке, человеком, человеку
staying - остаётесь, остаюсь, остаются, остается
older - старший, старше, старшая, старее, старшей, старшие, старших
young - молодой, молодая, молод, маленькие, молода, молодого, молодом, молоды, молодые, молодым, молодыми, молодых
six - шесть, шесть лет, шести, 6, шестой, шестом, шесть часов
mom - мама, мамы, маму, маме, мамину, мамой, мать
weren't - не были, не была, не был, не было
so - так, так что, так и, итак, настолько, потому, поэтому, столько, такая, такие, таким, такими, такое, такой, такой уж, то есть, чтобы
mrs. - Миссис
university - университет, университетскую, университета, университете, университетом
painting - картина, картину, живопись, картине, картиной, красил, рисует
class - класс, урок, классе, занятие, занятии, занятий, занятия, класса, классом, классу, урока, уроке, уроку
excuse me - извини, извинить меня, извините, простите
which - какой, которая, который, в каких, в какой, в какую, какая, какие, каким, каков, какое, каком, какому, какую, которого, которое, которой, котором, которую, которые, на каких, на какую, по какому, чего, что
one - один, одна, одно, одним, одного, одной, одну
brought - принесла, принёс, привез, привел, привозили, привёз, принес, принесли, приносили
business - бизнес, дело, бизнесом, бизнеса, бизнесе, дела, деловые, деловыми, деловых
any - никаких, какие-нибудь, какая-нибудь, какие-либо, каких-нибудь, какое-нибудь, какой-нибудь, каком-нибудь, кем-нибудь, кто-нибудь, любая, любого, любое, любой, любом, любому, любую, любым, любых, ни на каком, никакая, никакого, никакой, никакую, —
four - четыре, четырём, 4, в четыре, четверо, четвёртом, четыре часа, четырех, четырьмя
heavy - тяжёлый, тяжёлое, тяжелая, тяжелое, тяжелому, тяжелую, тяжелые, тяжелый, тяжелым, тяжёлая, тяжёлые
i would like - я хотела бы, я бы хотела, я хотел бы, я хочу, я бы хотел, Мне хочется
light - свет, лёгкий, светлые, легкое, легком, лёгкая, лёгкие, света, светло, светлого, светлое, светлый, светлых
lives - живёт, жизней, жизнях, водится, живет, жизни
near - возле, около, рядом, близко, близко к, рядом с, рядом со, у
a lot of - большой, множество, многих, многим, множеством, много, многие, многими
friend - друг, друга, другом, друге, другу, подруга, подруге, подруги, подругой, подругу
to go - идти, ехать, ходить, ездить, пойти, осматривать, поехать, шли, чтобы пойти, выходить, с собой, сходить, поехала
look - смотри, посмотреть, смотреть, будем искать, выглядела, выглядеть, выглядит, выглядишь, выглядят, выгляжу, искать, поискать, посмотри, посмотрим, посмотрите, посмотришь, смотрела, смотрим, смотрите, смотришь, смотрю, смотрят
art - искусство, искусстве, искусств, искусства, искусству
to go to - big - большая, большой, большие, большим, большими, больших, большого, большое, большом, большую, велик, велика, велики, велико, серьезная, серьезное, серьезной, серьезный, серьёзная, старшая, старший
there's - находится, есть, там, -, вот, держите, вот, держи, будет, before - раньше, до, до того, до того, как, перед, перед тем, как, пока, пока не, прежде, прежде чем, ранее
bus station - автовокзале
get off - встаньте с, выходи, встать с, выйти
center - центре, центр, центра, центром, центру
heard - слышал, слышала, слышали, слыхал, слыхала, услыхали, услышал, услышала, услышали
somewhere - где-то, куда-то
was going - ходила, ходил, собирался, шел, ехал, ехала, шла
early - рано, пораньше, раннее, ранней, ранний, ранняя
who - кто, кого, кому, за кем, за кого, кем, ком, которая, которой, которые, который, на кого, на ком, у кого
single - одноместный, одноместном, не замужем, единственным, одноместного, одноместных, холостые, холост
wow - ух ты
morning - утро, утром, утра, утренней, утренние
cafe - кафе
again - снова, опять, больше, ещё раз
crazy about - без ума от
online - сеть, онлайн
unfortunately - к сожалению
professor - преподаватель, профессор, профессором, профессора
friday - пятницу, пятница, пятницам, пятницы
posted - выложил, выкладывала, выложили
выложила
life - жизнь, жизни, жизнью
unusual - необычная, необычное
hawaii - information - информации, информация, информацию, информационный
take a trip - съезди в путешествие, съездить в путешествие
съездим в путешествие, ездим в путешествие
brother - брат, брата, братом, брату
she's - ей, она
anybody - кто-нибудь, кто угодно, кто-либо, кем-либо, кого угодно, кого-то, никого, никому, угодно
nobody - никто, никому, никто не
friends - друзья, друзей, друзьями, друга, друзьям, подругами, подруги
everybody - все, всем, каждый, всеми, всех, всякий, каждого
room - комнате, комната, комнату, кабинет, кабинете, комнаты, места, место, номер, номера, номере
won't - не, не буду, не будет, не будем, не будут, не станет
shh - тсс
about - о, об, о (ком?, чём?), в, за, из-за, обо, около, приблизительно, примерно, про, про (кого, что), размером
loudly - громко
son - сын, сына, сыну, сыне, сыном
by the way - кстати
no way - не может быть
didn't - разве, не, нет
nearby - близко, рядом, поблизости
party - вечеринка, партии, вечеринку, вечеринке, вечеринки, партия
told - сказал, сказала, рассказал, говорил, говорила, рассказала, рассказали, рассказывал, рассказывала, сказал, чтобы, сказала, чтобы, сказали
gossiping - сплетничает
gossips - сплетничают
makeup - макияж, макияжа
real - настоящая, настоящий, настоящие, настоящего, настоящее, настоящим, настоящими, реальна, реальной
there is - находится, в, лежит, —, есть, находятся, имеется, стоит
shouldn't - не следует, не должен, не должны
other - другой, другие, другом, другая, другим, другими, других, другое, другому, другую, ещё, иная, прочая
english - английский, по-английски, английский язык, английская, английские, английским, английского, английской, английском, английскому, английскую, на английском
boring - скучный, скучная, скучных, скучно, скучное, скучной, скучные, скучным
speak - говорю, говорите, говорим, говори, говорит, говорить, говоришь, говорят, говорящим, поговори, поговорите, разговариваем, разговариваешь, разговаривать, разговариваю, разговаривающим
sometimes - иногда
statue - статуей, статуе, статуя, статую
statues - статуях, статуи, статуями, eight - восемь, восьми, восьмом, восьмому
twenty-five hundred - 2500
more - больше, ещё, более, большего, больший, дольше, побольше
twelve hundred - 1200
actually - вообще-то, на самом деле
enough - достаточно, хватит
don't worry - lent - дала в долг, давал в долг, одолжил, дал в долг
одолжила
wallet - бумажник, кошельком, кошелёк, бумажником, кошелек, кошелька, кошельке
dollars - долларов, доллара, доллары, долларах
less - меньше, менее
definitely - определённо, несомненно, совсем
never - никогда, никогда не, ни разу, так и не
million - миллион, миллионов, миллиона, миллионом
silver - серебряную, серебряных, серебряный, серебра, серебро, серебряное, серебряная, серебряные
day - день, днём, дня, дне, днем, сплю
going to - будем, буду, собирается, собираемся, будут, идет на, едет, поеду в, будет, будете, собираюсь, собираешься, собираются, идет в, идем на
even - даже, чётные, чётное, ещё, равные, чётного
won - выиграл, выиграла, выиграли, выигрывал, выигрывала, выигрывали, победил, победила, получил, получила
lottery - в лотерею, лотерею
quit - бросила
бросить, бросай, sweater - свитер, свитером, свитере, свитера
how long - какой длины, сколько, как долго
glasses - очки, стаканов, очков, бокалы, которые, стакана, стаканы
took off - снял, взлетел
сняла, make noise - шуметь
making noise - шумят, шумит
take off - сними, снять, снимите, взлетают, снимать, снял, снимай
that one - тот, то, та
expensive - дорогой, дорогая, дорогое, дороги, дорогие, дорогим, дорогими, дорого, дорогом, дорогую
red - красные, красный, красная, красна, красного, красное, красной, красном, красному, красную, красным, красных, рыжая, рыжие, рыжий, рыжими
happy - счастливы, счастлива, счастливый, доволен, довольна, довольная, довольны, довольный, рад, рада, рады, счастлив, счастливая, счастливо, счастливого, счастливое, счастливой, счастливые, счастливым, счастливыми, счастливых
fifteen hundred - 1500
i like - мне нравится, я люблю, мне нравятся
moved - переехала, переехали, двигался, двигалась, переезжал, переезжали, переехал
bracelet - браслет
give - дайте, (!) дай, дать, давала, давали, давать, дадим, дадут, даем, дает, дай, дал, дала, дали, дам, даст, дашь, даю, дают, даём, даёт, отдавайте, отдадим, отдай, отдайте, отдал, отдаст, отдать, отдаю, передадим, передайте, передать, подарим, подарить, подарю, подают, сообщить, указал, указать, уступаю, уступи, уступить
necklace - ожерелье
next to - рядом со, вслед за, рядом с, возле
broken - сломана, сломаны, разбит, разбито, разбитое, разбиты, сломан, сломанное, сломанной, сломанный, сломано
dishes - посуду, посуды, блюд, блюда, посуда
today - сегодня
around - по, вокруг, поблизости, неподалёку, около
ago - назад, тому назад
he'll - ему, он будет, его, он
how - как, насколько, чем
thousand - тысяча, тысячу, тысяч, тысячей, тысячи
called - звонил, мне, звонили, вызвал, вызвали, звал, звонила, называется, называл, называются, позвали, позвонил, позвонила, позвонили
dad - папа, папы, папу, отец, папе, папой
later - позже, спустя, позднее, потом
box - коробке, коробку, коробка, коробки
kept - оставила себе, сдержала, сдержал, деражала, держал, держала, задержала, продолжала, продолжали, продолжила, продолжили, сохранила, хранил, хранила, хранили
clothes - одежда, одежду, одежды, одежде
i've - мне, я
often - часто
borrow - взять в долг, беру в долг, брать в долг, одолжить
borrowed - взяла в долг, одолжил, взял в долг
save - копить, накопишь, накоплю, оставим, оставить, оставлю, оставь, сохранил, сохранить, сохраняет
not big - небольшое, небольшой
terrible - ужасная, страшная, страшное, ужасна, ужасно, ужасное, ужасной, ужасном, ужасные, ужасный, ужасным
twice - дважды, вдвое
sunglasses - солнцезащитных очков, солнцезащитных очках, солнцезащитные очки
bathing suit - купальника, купальник, купальнике
showered - мылся, принял душ
so much - everything - всё, всему, всём, всего, всем
electricity - электричество, электричестве, электричества
ok - хорошо, OK, в порядке, ладно, нормальная, нормально, нормальные, нормальный, нормальным
knife - нож, ножом, ножа
alcohol - алкоголь, алкоголя
beer - пиво, пива
special - особенная, особый, особые, особая, особенна, особенного, особенное, особенной, особенную, особенны, особенные, особенный, особенным, особенных, особое, специальная, специальное, специальном, специальные, специальный
burger - бургер
have to - должен, обязан, должна, должны, обязаны, нужно, обязана
bar - бар, баре, бара, барной стойки
burgers - бургеры
cash - наличными
наличные, наличных
ninety - девяносто, девяноста, девяностого
polite - вежлив, вежливо, вежливый, вежливым, вежливая, вежливые
credit card - percent - процент
процента, процентов
wine - вино, вина, вином, вине
server - официантом, официант, официантка, официанту
fifteen - пятнадцать, пятнадцати, тысяча пятьсот (год)
leaves - уходит, листья, оставляет, листьев, листьями, листьях, оставит, отходит
leave - уйти, ухожу, выйду, выйдете, оставить, оставишь, оставлю, оставляет, оставляешь, оставляй, оставляйте, оставлять, оставляю, оставляют, оставь, оставьте, отпуск, покидать, покидаю, покидают, покинут, покинь, покиньте, уедем, уедет, уеду, уезжаешь, уезжать, уезжаю, уехать, уйду, уйдём, улетает, улететь, уходим, уходите, уходят
good at - сильны в, силен в, умею, сильна во, сильна в, умеет
physics - физический, физике, физику, физика, физическом
chemistry - химию, химия, химии
childhood - детство, детстве, детства
quizzes - quiz - самостоятельную работу
biology - биологии, биология
good at - сильны в, силен в, умею, сильна во, сильна в, умеет
geography - географию, география
understood - понял, поняли, поняла, понимала
all over - по всему, по всей
chef - шеф-повар, повару, шеф-поваром, шеф-повара, повар, повара
so - так, так что, так и, итак, настолько, потому, поэтому, столько, такая, такие, таким, такими, такое, такой, такой уж, то есть, чтобы
home - дома, домой, дом, домашнюю, домом, дому, родном
lived - жил, жили, жила, живут, живёт, жило, прожил, прожила, прожили
interested in - заинтересован, интересуетесь, интересовался, интересуется, интересуешься, интересуюсь, заинтересована
famous for - international - международный, международная, международные, международного, международное, международной, международном, международную, международным
studied - изучено, изучал, изучена, занимался, изучала, изучали, изучают, изучен, училась, учились, учился
dark - темно, тёмные, тёмная, темнота, тёмно, тёмном, тёмный, тёмным
soccer - футбол, футбольной, футбольный, в футбол, футбола, футболе, футболом, футболу, футбольная, футбольному, футбольную, футбольные
tall - высокий, высокое, высокие, высок, высокая, высоким, высокими, высоких, высокого, высокой, высокому, ростом
to be - стать, быть
many - много, многие, многим, многими, многих, множество
woman - женщина, женщину, женщиной, женщин, женщине, женщины
famous - известный, знаменит, знаменитый, знаменита, знаменитая, знаменитого, знаменитое, знаменитой, знаменитую, знамениты, знаменитые, знаменитым, знаменитыми, знаменитых, известен, известна, известная, известного, известное, известной, известном, известному, известную, известны, известные, известным, известными, известных, славятся
popular - популярен, популярна, популярная, популярно, популярное, популярной, популярному, популярны, популярные, популярный, популярным, популярными
company - компании, компания, компанией, компанию
teacher - учитель, учителем, учителю, преподавателем, преподаватель, учительница, учительницей, учителя
child - ребёнок, ребёнка, ребёнком, дитя, ребенка, ребенком, ребенку, ребенок, ребёнку
funny - забавно, смешная, забавную, смешно, забавное, забавных, забавным, смешные, забавный, забавная, забавные, смешным, смешной, забавной
homework - уроки, домашнее задание, домашней работой, домашней работы, домашним заданием, домашнюю работу, домашняя работа, задания
nineteen seventy - 1970
fifty - пятьдесят, пятьюдесятью, пятидесяти, пятидесятом
went - пошёл, пошла, ходил, вышел, вышла, ездил, ездила, ездили, занимался, отправились, отправился, подошёл, поехал, поехала, поехали, пошел, пошли, прошел, прошла, прошло, ушла, ушли, ушёл, ходила, ходили, ходит, шел, шли, шёл
a little - маленькая, небольшое, чуть-чуть, немного, маленькой, маленький
what's - что, как, какие, какое, какая, какой
changed - изменился, изменила, изменило, заменили, изменены, изменил, изменили, изменились, переоделся, пересела, пересела на другой, поменяла, свое
high school - старшие классы, старшая школа, старших классах, классы, старших классов
graduates - выпускники, выпускников
changes - перемен, меняется, изменений, изменениях, изменится, переодевает
classmate - одноклассницей, одноклассник, одноклассником
change - меняются, изменить, меняют, изменение, изменения, изменит, измените, измениться, изменятся, меняется, меняй, менять, меняться, меняюсь, переодевай, переодену, переодень, переодеть, переодеться, поменяем, поменяешь, поменяй, поменял, поменять, поменяться, сдача, сдачи, сдачу, сменить
through - сквозь, через, в, насквозь, посредством
wind - ветер, ветром, ветра
north - север, севере, северный, на север, северная, северном, севером
tying - south - юг, юге, юга, на юг, югом, южной, южную, южный
snow - снега, снегу, снег, снегом
lying down - ложимся, ложишься
country - страны, страна, стране, страной, страну
who - кто, кого, кому, за кем, за кого, кем, ком, которая, которой, которые, который, на кого, на ком, у кого
camping - поход с палатками, в поход с палатками, кемпинг, походов с палатками, походы с палатками
nature - природа, природу, природе, натура, натуре, природы
when - когда
lost - потерял, потеряла, проиграли, потерялась, потеряли, потерялись, потерялся, проиграл, проиграла, терял
which - какой, которая, который, в каких, в какой, в какую, какая, какие, каким, каков, какое, каком, какому, какую, которого, которое, которой, котором, которую, которые, на каких, на какую, по какому, чего, что
half past ten - how about - как насчёт того, чтобы, как насчёт, как насчет
extra - дополнительная, дополнительную
дополнительной, дополнительно, дополнительные
roof - крыша, крыше, крышей, крыши, крышу
golf - just - только, просто, только что, всего, как раз
maybe - может быть, возможно
how are you doing - как дела?, Как у тебя дела?
can't wait - that's all right - ничего страшного
i'd love to - я бы с удовольствием
half past eight - половины девятого
till - до
take care - береги себя, позаботиться, берегите себя, позаботься
fantastic - превосходную, превосходная, превосходные, превосходном, превосходным, превосходно, превосходный
half past six - половина седьмого
how about - как насчёт того, чтобы, как насчёт, как насчет
i don't mind - я не против
another - другой, ещё, другом, другая, другим, другого, другое, другую, еще один, ещё один, ещё одна, ещё одно, ещё одного, ещё одной, ещё одну
would you mind - вы не против того, чтобы, ты не против того, чтобы
pregnant - беременной, беременных, беременные, беременны, беременна
weekly - еженедельный, еженедельно, на неделю, еженедельная, еженедельные
heat - жара, жаре, тепло, жар, жару, отопление, отоплением, отопления
full - полон, полный, полна, полная, полно, полное, полные, сыт
cut myself - порезалась, порезался
herself - себя, сама, самостоятельно, саму себя, себе
awful - ужасный, кошмарный, кошмарным, ужасная
yourself - сам, себя, сам себе, сама, сама себе, сами себе, самому, себе, собой
anything - ничего, ничего (при отрицании), что-нибудь, всё, нечего, чем-нибудь, что угодно, что-либо, что-нибудь (в вопросах)
broke - сломал, разбила, разбил, нарушили, разбилась, разбили, сломала, сломалась, сломали, сломался
myself - себя, сам, сама, самостоятельно, себе, собой
himself - сам, себе, себя, себя самого, собой
made - сделал, приготовленный, сделали, готовил, готовила, делается, заключили, заставил, изготавливается, изготовлена, изготовленные, изготовлены, приготовил, приготовили, принял, произнесла, сделала, сделало, сделан, сделана, сделанная, сделанное, сделанные, сделанный, сделано, сделаны, совершил, совершили, создан
worst - худшее, худший, худшая, наихудшие, самое плохое, самым худшим
while - пока, тогда как, в то время как, а, до, когда, наряду с тем, что, хотя
gold - золото, золотое, золота, золотая, золотой, золотую, золотые, золотых
upstairs - наверху, наверх, вверх по лестнице
were driving - ехали на машине, ехала на машине, ехали
ехал на машине, magic - волшебной, магии, волшебными, волшебная, магию, магия, волшебный, волшебном, волшебное, волшебные
were going - ехали, шли, ехала, was living - жил, жила, проживала
stole - украл, украла, украли
badly - очень сильно, плохо, сильно
all kinds of - quietly - тихо, спокойно
against - против, к
ours - наши, наша, наше, наш, нашего, нашей, нашими, нашу
easily - легко, просто, свободно
happily - с удовольствием, радостно
final - окончательный, финальный, последний, окончательно, окончательное, окончательным, последних, финальной, финальном
threw - бросил, бросила
hit - попала, бить, бьешь, бью, отбить, ударил, ударила, ударило
aren't any - half-price - вдвое дешевле
flour - мука, муки
yogurt - йогурт, йогурта
gum - жвачку, жвачка, жвачки
else - ещё, другой, остальные, другим, другого, другое, другом, ещё (помимо)
over - вон, над, по, более, больше, за, закончился, закончится, кончено, на протяжении, окончена, поверх, свыше
jelly - желе, варенья, конфитюра
isn't any - plastic - пластиковые, пластиковых, пластик
a little - маленькая, небольшое, чуть-чуть, немного, маленькой, маленький
cost - стоит, стоить, стоят, затрата, обходится, стоил, стоила, стоили, стоило, стоимость, цена
woke up - проснулась, разбудили, проснулся
same - тот же, такой же, ту же, один и тот же, одинакова, одинаковая, одинаковый, одна и та же, одна общая, одних и тех же, одно и то же, одном, одном и том же, ту же самую
coworkers' - pajamas - пижама, пижаму
weekdays - будни
put on - надевай, надел, надеть, надела, включить, включу, надену, включил, надеваю, положила ... на, надевать, надень
kids' - weekday - будний день
got on - сели на, сел, села, сели
half past nine - half past seven - половина восьмого
lay down - лег, легла
half - половину, половина, вполовину, наполовину, пол, половине, половины
roommates' - toast - тост
half past one - половина второго
grew up - выросла, выросли, вырос
met - встречал, встретили, встретила, встретил, встретились, встречала, встречали, встречались, знакомились, знакомился, познакомилась, познакомились, познакомился, познакомился с, познакомился со
interesting - интересная, интересный, интересно, интересен, интересна, интересного, интересное, интересной, интересному, интересную, интересны, интересные, интересным, интересными, интересных
crazy - сумасшедшие, безумную, безумными, сумасшедшим, сумасшедших, сумасшедший, в безумных, безумных, сумасшедшими, сумасшедшее, сумасшедшая, безумное, сумасшедшую, безумные, безумно, сумасшедшем
each other - друг в друга, друг друга
друг с другом, друг другу
tried - пробовал, пытался, попробовал, попробовала, попробовали, попыталась, попытались, попытался, пробовала, пробовали, пыталась, пытались, старались
knew - знал, знали, знала
all the time - всё время
growing up - растут, растем, we've - мы
could - можете, умели, мог, могла, могли, могло, могло бы, смог, смогла, умел, умела
couldn't - не смогла, не умела, не смогли, не мог, не смог, не могли
any - никаких, какие-нибудь, какая-нибудь, какие-либо, каких-нибудь, какое-нибудь, какой-нибудь, каком-нибудь, кем-нибудь, кто-нибудь, любая, любого, любое, любой, любом, любому, любую, любым, любых, ни на каком, никакая, никакого, никакой, никакую, —
gone - ушли, ушёл, ушла, ездили, занимался, зашла, зашли, зашёл, поехала, пошли, уехала, ходил, ходила
mine - моя, мой, мои, моего, моей, моим, моих, мою, моё, моём, свою
everywhere - всё, повсюду, везде
ride - подвезти, ездит, катаюсь, катаются, проедет на, ездить, проедет, катаемся, катается, покататься, кататься
hiking - походы, поход, похода, походный
snowboarding - кататься на сноуборде, покататься на сноуборде
spent - провели, провела, провёл, потратил, потратила, потратили, проводил, проводила, проводили, тратили
belarus - Белоруссия, Беларуси, Беларусь, Белоруссии
miss - скучаю, скучать, будет скучать, девушка, мисс, пропускаем, пропускай, пропускаю, пропустить, скучаешь, скучаю по
cried - заплакала, плакал, заплакал, плакала, плакали
aw - ой
ex - бывшую, бывший, бывшим, бывшей, бывшая, бывшего
exes - бывших
Spanish - испански, по-испански, испанского, испанец, испанка, испанские, испанский, испанский язык, испанском, испанскому, испанскую, испанцы
sense of humor - чувство юмора
French - французский, французски, по-французски, француженка, француз, французов, французская, французские, французский язык, французского, французское, французской, французском, французскому, французскую, французы
worried - встревожен, переживала, переживал
обеспокоен
call me - звони мне, позвони мне, позвонить, upset - расстроилась, расстроился, расстроен, расстроена, расстроенной, расстроенным, расстроены
worry - беспокоиться, беспокоимся, беспокойтесь, беспокойся, беспокоются, волнуйся, волнуйтесь, переживать, переживаю
spoke - говорил, говорила, говорили, поговорил, поговорила, поговорили, разговаривал, разговаривали
german - немецкий, по-немецки, немец, германия, немецкая, немецкие, немецкого, немецкое, немецком, немецкому, немка
born - родился, рождены, прирождённый, родилась, родились, рожден, рождена, рождён, рождённый, урождённый
have fun - повеселись, веселимся, веселюсь, spend - потратить, проведём, провели, потратила, потратит, потратят, провела, провести, проводим, проводить, проводят, провожу, провёл, тратить, тратят, трачу
hasn't - grow up - вырасти, взрослеют, вырастешь, вырастут, вырасту, вырастают
cute - милого, славную, славные, милая, славное, славная, милые, милый, славным, славный, славными
new - новый, новая, новую, нового, новое, новой, новом, новому, новые, новым, новыми, новых
ugly - ужасная, ужасную, ужасное, ужасные, ужасной, ужасный
shirts - рубашки, рубашках, рубашек
hello - привет, здравствуйте, здравствуй
built - построен, построено, строил, построена, построенная, построенные, построены, построил, построила, построили, строили
well-known - известная, известные, известный, известны
thought - думал, думали, думала, думает, думал, что, думала, что, мысли, мысль, подумал, подумала, подумали, показалось
downtown - в центре города, в центр города, центр города
exactly - точно, именно
shortest - самый короткий, самый низкий
as - как, как и, так, в качестве, в то время как, где и, как (качество), насколько, настолько, пока, столь же, так же, так как, такая же, такие, таким, такими же, такое же, такой, такой же, что, что и
what's the weather like - какая погода
at least - как минимум, по крайней мере, по меньшей мере
across from - напротив
almost - почти, чуть не
down - по, вниз
modern - современный, современная, современные, современно, современного, современное, современном, современную, современным
along - по, вдоль
sure - уверена, уверен, уверены, конечно, точно, уверен, что, уверена, что, уверенным, уверены, что
eating - ест, есть, ем, еда, едите, едят, ешь, поесть, съесть
eleventh - одиннадцатое, одиннадцатый, одиннадцатого, одиннадцатая
baking - пеку, печешь
thirty-first - celebrating - отмечу, отметишь, празднуют, отметим
inside - в, в доме, внутри, внутрь, дома
champagne - шампанского, шампанское
skiing - покататься на лыжах, катаюсь на лыжах, кататься на лыжах
thanksgiving - День Благодарения
twenty-third - twelfth - двенадцатого
New year's eve - Новый год
it'll - это будет, будет
blood - кровь, крови, кровяное
should - следует, стоит, должен, должно, должны, нужно
should not - не должна, нельзя, не следует
chocolate - шоколад, шоколадный, шоколада, шоколаде, шоколадная, шоколадного, шоколадное, шоколадные
pain - боль, боли, болью
what's the matter - что случилось
health - здоровье, здоровья
in shape - в форме
good for - полезно
hurt - болят, болела, болит, повредил, повредила
felt - чувствовала, чувствовала себя, почувствовал, ощущала, ощущала себя, почувствовала, почувствовала себя, почувствовали себя, чувствовал, чуствовал себя
dr. - internet - интернет, интернете, интернету, интернетом
businesswoman - деловой женщиной, деловая женщина, деловой женщины
staff - персонал, штаба, персонала, коллектив, коллектива, коллективе, коллективом, коллективу, персонале, работники, работников, сотрудники, штат
software - программном обеспечении, программное обеспечение
businesswomen - деловые женщины, деловыми женщинами, деловых женщин
these days - в наши дни, в последнее время, в эти дни
tomorrow - завтра, на завтра
clients - клиентах, клиентов, клиенты, клиентами, клиентам, с клиентами
open - открыть, открыта, открыт, (!) открой, (!) откройте, (!) открывай, открой, откройте, откроют, открываем, открываете, открывается, открываешь, открывайте, открывал, открывать, открываю, открывают, открыл, открыла, открыли, открылись, открытая, открыто, открытое, открытой, открытую, открыты, открытый, открытым, открытыми, открыться
clean - чистые, чистый, чистая, в чистоте, почисти, почистим, почистить, убери, уберу, убираем, убирает, убирать, убираться, убираю, убираюсь, убираются, убрать, убраться, чиста, чисти, чистить, чистишь, чистой, чистую, чистым, чистыми, чистых, чистят, чищу
he's - он будет, ему будет, это, он
one moment - nervous - нервничаю
нервничала, нервничал, нервничай, нервничаешь, нервный, нервничают, нервничаете, нервничает, нервные
usually - обычно
prints - печатает
coming - приедут, идёт, идёте, идут, приезжало, приезжают, придёт, идет, приедет, приезжает, придешь
придет, идешь
creating - создадим
also - тоже, также
doctor - врач, врача, врачом, врачу, доктор, доктора, доктором, доктору
engineer - инженер, инженера, инженере
latvia - Латвия, Латвию, Латвии
get along - ладят, ладим, ладить, полажу, лажу
personal assistant - kind - добрый, вид, доброе, вида, добр, добра, добрая, доброй, добры, добрые, добрым, добрыми, род, тип
the best - лучший, лучшего, лучшим, наилучший, самые лучшие, наилучшего, лучшие, лучшими, лучшем, лучшее, лучшая, лучших
farmer's market - фермерском рынке, на фермерском рынке, фермерский рынок
across - через, за, на другой стороне, на другую сторону, на той стороне, напротив, по
wasn't - не была, не, не был
watched - смотрели, смотрел, посмотрела, наблюдали, посмотрел, посмотрели, смотрела
gas - бензин, газ, бензина, газа, газом
twenty-five - design - дизайн, дизайном, дизайна, оформление, создать, узор, эскиз
then - потом, тогда, то, в таком случае, затем, значит
drink - пьют, пью, пить, выпей, выпейте, выпивают, выпить, выпьем, выпьет, выпьешь, напитка, напиток, пей, пейте, попить, пьем, пьет, пьешь, пьёт, пьёте, пьёшь
no - нет, не, никакого, без, нету, никаких, никакой, ноль
sweetheart - дорогой, дорогая
weak - слабый, слабые, слабая, слаб, слаба, слабое, слабой, слабы, слабым, слабыми, слабых
became - стала, стал, стало, стали, становилось
gotten - получил
брал, получал, получили, hudson river - река Гудзон
boarding pass - посадочный талон
dance - танцевать, танец, танцевальными, бал, балу, танца, танцуем, танцуете, танцую, танцуют
fattest - толстые, самый толстый
самая толстая, самые толстые
dollar - доллар
nineteen - девятнадцать, девятнадцати, тысяча девятьсот (год)
tennis - теннис, теннисную, теннисом, в теннис, тенисную, теннисе, теннисный
fourteen - четырнадцать, четырнадцати
go - идти, хожу, пойти, выйти, едем, едет, едешь, еду, едут, ездим, ездить, ездишь, езжу, ехать, зайдем, занимаешься, занимаются, идем, идет, идешь, иди, идите, иду, идут, идём, идёт, идёте, осматривать, поедем, поедет, поедете, поедешь, поеду, поедут, поезжай, поезжайте, поехать, пойдем, пойдет, пойдешь, пойди, пойду, пойдут, пойдём, пойдёт, пойдёте, пойдёшь, пошел, пошёл, приезжать, приезжают, проедет, проедешь, проеду, проехать, пройдете, пройти, проходите, прошла, прошло, ступай, сходить, уйдёте, уйти, уходи, ходи, ходила, ходили, ходим, ходит, ходите, ходить, ходишь, ходят
welcome - добро пожаловать, поприветствовать, поприветствуем, приветствуется
meat - мясо, мяса, мясом
on - на, в, по, включаем, за, над, при, уборка
scary - страшное, страшная, страшно, страшной, страшном, страшные, страшный, страшным, страшными
younger - младший, младшая, младше, младшему, младшие, младшим, моложе
beautiful - красивая, красива, красивый, красиво, красивого, красивое, красивом, красивую, красивые, красивым, красивыми, прекрасен, прекрасна, прекрасная, прекрасно, прекрасное, прекрасны, прекрасные, прекрасный
the united kingdom - великобритании
came - пришёл, пришли, вошла, подошли, подошёл, приезжала, приехал, приехала, приехали, прилетел, приходил, приходили, пришел, пришла, пришло
pharmacy - аптеку, аптека, аптеке, аптекой
mr. - мистером, мистер
me - мне, меня, я, за мной, мной, мною, по мне, себя
kazakhstan - Казахстан, Казахстана, Казахстане
russians - россияне, русские
fried - жареная, обжарили, жарили, жарил, жареную, жареные, пожарили, пожарил, жареный, пожарила
cooler - класснее, круче, покруче
romantic - романтично, романтичный
canada - Канада, Канады, Канаде, Канадой, Канаду
there - там, туда, есть ли
world cup - Кубок Мира, Кубка Мира, Кубке Мира
rent - арендовать, снимаем, снимаю, аренда, арендовала, аренду, арендуем, арендует, арендуете, арендую, снимаете
go shopping - ходим за покупками, пойти за покупками, пойдем за покупками
fifteenth - пятнадцатого, пятнадцатое, пятнадцатом
cooks - готовит, варит, повара
about - о, об, о (ком?, чём?), в, за, из-за, обо, около, приблизительно, примерно, про, про (кого, что), размером
vegetarian - вегетарианец, вегетарианцы, вегетарианка, вегетарианские, вегетарианский, вегетарианским, вегетерианские, вегетерианский, вегетерианскую
fresh - свежих, свежий, свежие, свежая, свежего, свежее, свежей, свежим, свежими, свежую
you've - ты, вы
to take - сделать, брать, ехать, сдавать, отвезти, взять, поехать, сесть, принял, чтобы принял, чтобы приняла, принимал
чтобы принимал, restaurant - ресторан, ресторане, ресторана, рестораном, ресторану
there wasn't - не было
writing - писать, пишущий, записываешь, записываете, надпись, написанию, написать, письме, письмо, пишет, пишущая, пишущими, рукописи, тексту
dogs - собаки, собак, собакам, псы
japanese - японский, японка, японцев, по-японски, японец, японские, японский язык, японскими, японских, японского, японское, японском, японскому
it - это, он, его, -, ей, ему, её, им, их, на ней, на неё, на нём, него, ней, неё, нём, она, они, оно, по ней, того, этим, этого, этом, этому
returned - вернулся, вернулись, вернул, вернула, вернулась
i don't understand - plays - играет, занимается, будет играть, играет в, играют, поиграет, пьес, пьесы
different - разные, другой, разных, другая, другим, другими, другое, другом, другую, иначе, не в такой, не такая, не такой, отличается, отлично, отличное, по-другому, различные, различный, различными, различных, разная, разного, разное, разную, разный, разными
library - библиотека, библиотеке, библиотеки, библиотекой, библиотеку
soccer game - футбольный матч
took - взял, взяла, выпила, брал, брали, взлетел, взяли, забрал, заняла, поехал, поехала, поехали, принял, приняла, сделал, сделала, сделали, снял фото, сфотографировал
do you like - тебе нравится, нравятся ли тебе, вам нравится, ты любишь, вам нравятся, вы любите, тебе нравятся
taller - выше, повыше
ridden - far - далеко, далека, дальний
talking - говорит, говорящая, говорящего, говорили, говорить, говоришь, говорю, говорят, говорящий, говорящих, говорящую, разговариваем, разговаривает, разговариваешь, разговаривать, разговариваю, разговаривают
have - есть, имеет, -, будет, бывает, бывают, была, было, выпить, выпьем, едим, едят, ем, ешь, имеем, имеете, имеется, иметь, имею, имеют, нет, попьем, пусть, съедим, съесть, у, у ... есть, устраиваем, устроим
friendliest - самые дружелюбные, самый дружелюбный
самая дружелюбная
ate - съел, ели, ел, ела, поел, поела, поели, съедала, съела, съели
london - Лондон, Лондона, Лондоне, Лондону
blond - белокурый, белокурая, белокурые
washed - мыла, помыл, помыла, помыли
out of town - am - нахожусь, быть, являюсь, буду, часов
wrote - написал, написала, писал, записал, написали, писала, писали
seventeen - семнадцать, семнадцати
mall - торговом центре, торговый центр, торговому центру, торговым центром
dances - танцует, балы, танцы
nineteen oh three - 1903
pizza - пицца, пиццу, пиццы
song - песня, песню, песне, песни
since - с, с того времени, с той поры, поскольку, с тех пор, как, со
paying - оплату, платить, платит, платят
behind - за, позади, сзади
were not - был, не были
o'clock - час, часов, часа
welcome to the team - most beautiful - carefully - аккуратно, осторожно, внимательно
wash - помыть, постирать, мыть, моем, моешь, мою, моют, мыться, помой, помойте, постирал
looks - выглядит, смотрит, выглядят, смотрится
takes - берёт, занимает, забирает, берет, будет взлетать, будет сдавать, взлетает, едет, отвозит, принимает, сдавать
would like - хочется, хотел бы, хочу, хотела бы
how often - как часто
danced - танцевала, танцевал, танцевали
florida - Флориду, Флориде
thank you for - for - для, на, за, -, благодаря, будет, в, в течение, к, о, по, ради, уже
movies - фильмы, кино, фильмов, фильма, фильмами, фильмах
had to - должна была, пришлось, должен был, должны были
before - раньше, до, до того, до того, как, перед, перед тем, как, пока, пока не, прежде, прежде чем, ранее
some - некоторые, немного, какую-нибудь, -, какая-то, какие-то, какими-то, каких-нибудь, какого-нибудь, какого-то, какое-то, какой-нибудь, какой-то, какому-то, какую-то, кое-какие, некоторое, некоторым, некоторыми, некоторых, несколько, чуть-чуть
clean - чистые, чистый, чистая, в чистоте, почисти, почистим, почистить, убери, уберу, убираем, убирает, убирать, убираться, убираю, убираюсь, убираются, убрать, убраться, чиста, чисти, чистить, чистишь, чистой, чистую, чистым, чистыми, чистых, чистят, чищу
you - ты, вы, тебя, вам, вами, вас, им, к вам, себя, твоей, твоем, тебе, тобой, у вас, у тебя
what - что, то, что, какой, в каком, из какого, из чего, как, какая, какие, каким, каких, каков, какова, каково, каковы, какое, каком, какую, кого, кто, о чем, о чём, сколько, тем, чем, то, чего, чего, чем, что такое, чём
partner - партнёром, партнер, партнера, партнёра
us - нас, нам, нами, американская, американской, к нам, мы
hungry - голодные, голоден, голодный, голодна, голодная, голодной, голодны, голодным, голодных
had - был, имели, имело, бывало, была, были, было, выпил, ел, ела, есть, имел, имела, появились, появился, съела, съели, у нас, у нас был
popcorn - попкорна, попкорн
swimming - плавание, плавать, купание, плавании, плаванию, плавания, плывёт, плыла, поплавать
summer - летом, лето, лета, лете, летнее, летнем, летние, летний, летних, лету
amazing - замечательно, замечательными, замечательная, изумительно, замечательный, замечательном, замечательным, замечательные
reading - читает, читаю, читать, прочтения, читаешь, читал, читала, читают, читающая, читающего, читая, чтение, чтением, чтения, что читала
hip-hop - хип-хоп, хип-хопа, хип-хопе
on the right - справа
russia - России, Россию, Россия
two thousand six - 2006
Italian - итальянский, итальянец, итальянка, итальянская, итальянски, итальянские, итальянским, итальянских, итальянского, итальянское, итальянской, итальянскую, по-итальянски
aren't - не будешь, не, разве не
cleans - убирается, убирает
russia - России, Россию, Россия
person - человек, человека, человеком, лицо, личность, особа, персона, человеку
rented - снимали, снимала, арендовал, арендовала, арендовали, снимал
a.m. - утра
hockey - хоккей, в хоккей, хоккее, хоккея
sleeps - спит, будет спать, спать
client - клиент, клиенту, клиента, клиентом
france - Франции, Францию, Франция
love - люблю, любят, любим, любви, любил, любила, любили, любит, любите, любить, любишь, любовь, любовью, нравится, обожаем, обожаешь, обожаю, обожают, полюбишь, понравится, понравишься
hockey game - хоккейный матч
straight ahead - прямо, прямо впереди
did not - не, стала
a few - несколько, немного, нескольким, несколькими, нескольких
by - на, у, к, -, в, возле, до, из, мимо, по, поблизости от, рядом с
wonderful - прекрасные, замечательно, отличном, чудесная, чудесно, чудесное, чудесные, чудесный, чудесными
thirty - тридцать, тридцати
from - из, от, с, со, у
can - можете, могу, можешь, бак, банке, мог, могут, можем, может, может ли, можно, смогу, смогут, сможем, способна, умеем, умеет, умеешь, умею, умеют
hottest - самое жаркое, самые жаркие, самая жаркая, самый жаркий
can't - не умеют, не умеет, не могу, не могут, не можем, не может, не можете, не можешь, не умеем, не умею, нельзя
has eaten - ела, съел, ел, поел
haven't - не
prettier - красивее, симпатичнее, симпатичней
rooms - комнаты, комнат, кабинетов, кабинеты, комнатах, номера, номеров
january - январь, январе, января
ice - льду, льдом, лёд, льда, лед, ледяную
originally - родом
years old - года, лет, год
to cook - приготовить, готовить, сварить
who's - кто
peru - Перу
do you like - тебе нравится, нравятся ли тебе, вам нравится, ты любишь, вам нравятся, вы любите, тебе нравятся
bird - птица, птицу, птицы, птице, птицей
starts - начинается, начинает, начинаются, начнет, начнется
european - европейский, европейская, европейские, европеец, европейскими, европейских, европейскую, европейцы
actress - актриса, актрисы, актрисой, актрисе, актрису
thursday - четверг, четверга
that - что, это, то, в котором, в том, кому, которая, которого, которое, которой, котором, которую, которые, который, которым, которых, на котором, на которых, на тот, с которым, та, так, так уж, такими уж, такого, такой, те, тем, того, той, том, тому, тот, ту, чего, чтобы, эта, этим, этого, этой, этом, этот, эту
difficult - сложный, трудный, трудное, сложная, сложно, сложное, сложные, трудная, трудно, трудной, трудные, трудных
game - игра, игру, игре, баскетбольная игра, игры, матч, матча, матче
main - главный, основная, главное, главная, главного, главной, главном, главному, главные, главными, основное
were - были, был, была, было, стоили, ты была
what a relief - какое облегчение
honey - мёдом, мёд, мёде, мёда
my - мой, моя, мои, в моей, в моём, за моего, к моим, мое, моего, моей, моем, моему, моим, моими, моих, мою, моё, моём, ни моей, свое, своего, своей, своем, своему, свои, своим, своими, своих, свой, свою, своя, своё, своём, у меня, у моего, у моей
live - живут, живу, жить, водятся, живем, живет, живешь, живущих, живём, живёт, живёте, живёшь, жил, жила, жили, проживёт, прожить
thin - худые, тонкая, тонкие, тонкое, тонкой, худая, худой
have visited - посетила, посетили, посещала
has - есть, у него, имеет, -, в, владеет, владеть, ест, иметь, нет, обладает, у, устраивает
feeding - кормишь, кормить, кормления, кормлю
twelve - двенадцать, двенадцати, двенадцатом
haven't kissed - rock - рок, камень, камня, рока
his - его, свою, своей, по своему, по своим, свое, своего, своем, своему, свои, своим, своими, своих, свой, своё, своём, у него
late - поздно, опоздал, опоздали, опаздываем, опаздывает, опаздываешь, опаздывала, опаздывать, опоздаем, опоздала, опоздать, поздней, поздние
practicing - заниматься
pork - свинину, свинина, свинины
ever - когда-нибудь, когда-либо, вечно, всё, никогда
forty-five - more dangerous - опасней, более опасный, опаснее
twenty ten - 2010
cheaper - дешевле, дешевая, более дешёвой, подешевле
is there - есть (ли), есть, там, здесь, ли
work - работе, работать, работаю, работа, работаем, работает, работаете, работаешь, работай, работайте, работал, работала, работали, работают, работой, работу, работы, рабочая, срабатывает
foreign - иностранных, иностранный, иностранные, зарубежной, зарубежном, зарубежную, зарубежных, иностранец, иностранная, иностранную
america - Америке, Америку, Америка, Америки
good - хорошая, хороший, хорошо, доброе, доброй, добрый, подходящее, подходящий, полезен, полезно, полезны, полезный, правильное, хорош, хороша, хорошего, хорошее, хорошей, хорошем, хороши, хорошие, хорошим, хорошими, хороших, хорошую
taking - Участвуешь, отвозила, беру, берешь, берёт, везет, везешь, везу, взлетает, забираю, писать, принимает
police officer - полицейский, полицейскому
healthy - здоровый, здоров, здоровы, здорова, здоровая, здорового, здоровое, здоровой, здоровую, здоровые, здоровым, здоровыми, здоровых, полезен, полезна, полезная, полезное, полезной, полезную, полезны, полезные, полезный
only - только, лишь, всего лишь, единственную, единственный, единственным, просто
ballet - балет, балета, балетом
to swim - плавать, искупаться, поплавать
running - бег, бегать, бегаем, бегающее, бегающий, беге, бегового, бегу, бегут, бегущей, бежать, бежит
i'm lost - boyfriend - парень, парня, парнем, парне, парню
traveling - едем, едет, едешь, еду, путешествовать
have - есть, имеет, -, будет, бывает, бывают, была, было, выпить, выпьем, едим, едят, ем, ешь, имеем, имеете, имеется, иметь, имею, имеют, нет, попьем, пусть, съедим, съесть, у, у ... есть, устраиваем, устроим
sixty - шестьдесят, шестидесяти
at home - дома
has never - никогда, никогда не
next - следующий, следующей, следующем, будущий, дальше, следующая, следующего, следующее, следующие, следующим, следующих, следующую, соседней, соседнем, соседний
does not - нет (не делает), не, нет
studying - изучаю, изучать, изучение, позаниматься, учеба, учебе, учится
useful - полезный, полезен, полезно, полезное, полезны, полезные
did - делал, сделал, делала, -, делали, занималась, занимался, сделала, собрала
free - бесплатный, бесплатно, свободен, бесплатна, бесплатная, бесплатное, бесплатной, бесплатном, бесплатную, бесплатны, бесплатные, бесплатным, бесплатными, бесплатных, свободна, свободная, свободно, свободного, свободное, свободны, свободные, свободный, свободным
humid - влажно
major - специальность, специальностью
have climbed - залезли
залезала, залезла, залез, залезали, залезли на, залезал, twenty nineteen - 2019
to - в, на, с, -, во, для, до, за, к, ко, по, со, чтобы
snakes - змеи, змей, змеями
was not - не была, не, не был, не было
september - сентябрь, сентябрём, сентябре, сентября
hi - Привет
meetings - совещания, собрания, встреч, встречи, митинги, собраний
basketball game - баскетбольный матч, баскетбольного матча
on the left - налево, слева
last - прошлом, прошлой, в прошлый, в последний раз, в прошлом, в прошлую, на прошлую, последнее, последней, последнем, последние, последний, последнюю, последняя, прошлая, прошлого, прошлое, прошлому, прошлую, прошлые, прошлый, прошлым
drove - проехал, проехали, вез на машине, везла на машине, везли на машине, вела машину, ездил на ней, ездила на машине, ездили, ехал на машине, отвёз, поехали, проехала
finished - закончил, закончили, завершил, завершила, завершили, завершён, закончила, закончить, окончили, прикончил, прикончила, прикончили, сделала
medicine - лекарство, лекарств, медицину, лекарства, лекарством, медицина, медицине
drew - нарисовала, нарисовал, рисовал, рисовала
sent - выслали, послал, послали, отправил, отправила, отправили, отправлено, послала, посылали
visit - визит, посетить, визита, навести, навестил, навестим, навестить, навестишь, навещаем, навещаете, навещаешь, навещать, навещаю, навещают, навещу, побывать, посети, посетите, посещаете, посещаешь, посещать, посещаю, посещают, посещение
swam - плавал, плавали, переплыл, переплыла, плавала, плыли, проплыл, проплыли
great - великий, отличный, большие, большое, большой, великая, великие, великим, великих, великолепный, великом, замечательно, замечательный, огромная, огромное, огромный, отличная, отлично, отличное, отличной, отличную, отличные, отличным, отличных, с большим, хороши
november - ноября, ноябрь, ноябрём
long - долго, давно, длинный, в длину, длинная, длинное, длинной, длинную, длинные, длинным, длинными, длинных, длиной, длительное, долгие, долгий, долгого, долгое, долгую
play sports - занимаетесь спортом, занимаешься спортом, занимаются спортом, заниматься спортом
hobby - хобби, увлечением, увлечение
math - математика, математике, математикой, математику
buying - покупку, покупаешь, покупает, покупаем, покупаю
paris - Париже, Париж, Парижа
feet - ступни, ноги, футах, футов
tomato juice - томатный сок
exciting - захватывающим, захватывающе, захватывающее
at - в, на, у, возле, за, по
likes - любит, нравится, нравятся
most interesting - need - нужно, надо, нужна, будет нужна, будут нужны, нужда, нуждаемся, нуждается, нуждаться, нуждаюсь, нуждаются, нуждаются в, нужды, нужен, нужны
nineteen ninety-eight - 1998
school - школу, школе, школа, университете, факультеты, школой, школы, школьная, школьное, школьной, школьном, школьную, школьные, школьный, школьных
study - учусь, изучаю, учиться, занимаемся, занимаетесь, занимаешься, заниматься, занимаюсь, занятий, занятия, изучаем, изучаете, изучаешь, изучали, изучать, изучают, изучить, исследование, научная работа, научную работу, обучаться, обучение, позаниматься, учатся, училась, учились, учился, учим, учимся, учитесь, учится, учить, учишься
more expensive - дороже, подороже
good night - спокойной ночи
mail - почта, корреспонденцию, почте, почту
basketball - баскетбол, баскетболом, баскетбола, баскетбольный, в баскетбол
i'm - я буду, мне, я
bosses - начальники, босса, боссам, боссами, боссы
seventy - семьдесят
washes - моет
china - Китае, Китай, Китая
cup of - better - лучше, больше, лучший, получше
africa - Африке, Африка, Африки, Африку
see you - вижу тебя, вас видим, тебя видеть, вас видят, увидимся, вас видеть, до скорого, пока
where's - где
kinder - добрее
there weren't - singing - поём, петь, поют, пою, пение, напевая, поёт
sugar - сахар, сахара, сахаром, сахаре
it'll be - будет
pizzas - пиццы, пицц
what time is it - сколько времени, Который час?
printers - принтеров, принтеры, принтера
twenty-three - two thousand four - 2004
dangerous - опасных, опасном, опасны, опасный, опасными, опасен, опасным, опасна, опасно, опасная, опасные, опасное
spicy - острое, острым, острый, острая, острой, острую
retired - на пенсии
to get - съесть, получить, чтобы получить, взять
thirteen - тринадцать, тринадцати, от тринадцати, тринадцатом
and you - cookies - печенья, печенье, печеньем, печеньки
rode - катался, катались, каталась, каталась на
this afternoon - сегодня днем
eighteen fifty-three - 1853
sandwiches - бутерброды, бутербродов, сендвичи, сэндвичи
going to go - пойдет, пойдем, пойду, поеду, пойдешь, пойдёт, собирается пойти
how are you - как у тебя дела, как дела, как ты, как у вас дела
excited - рад, рады, рада
may - могу, май, можешь, возможно, мае, маем, мая, могут, можем, может, можете, можно
weather - погода, погоду, погоде, погодой, погоды
smart - умный, умная, умной, умные, умным, умных, умён
flew - летел, пролетело, улетел, летали, прилетела, улетела, управлял, управляли
smoking - курит, курить, курение, курения, курю, курят, покурить
chores - работу по дому, работ по дому, работы по дому, работа по дому, работой по дому
hundred - сто, ста, сотни
ms. - Миз
hot - жарко, горячий, горячая, горячего, горячее, горячей, горячие, горячую, жаркая, жаркий, жаркое, острый, острым, острых
blue - синий, синяя, синей, в синий, голубая, голубое, голубой, голубую, голубые, голубыми, сине, синего, синее, синем, синие, синии, синим, синими, синих, синюю
yellow - жёлтые, жёлтый, жёлтая, желтое, желтой, желтую, желтые, желтый, желтых, жёлт, жёлтого, жёлтое, жёлтой, жёлтом, жёлтую, жёлтыми, жёлтых
sold - продал, продали, продается, продала, продан, продана, проданы, продаются, продаётся
genius - гений
left - налево, левой, осталось, вышедших, вышел, вышли, забыл, забыла, левая, левого, левое, левом, левую, левые, левый, оставил, оставила, оставили, оставлена, оставленным, осталась, остался, покинул, покинула, покинули, уехал, уехала, уехали, улетал, улетел, улетела, ушел, ушла, ушли, ушёл
not going - colorful - пёстрая, пёстрое, разноцветного, разноцветной, разноцветную, разноцветные, разноцветными, разноцветных, яркая, яркое
own - собственная, собственные, собственный, владеет, владеть, владею, владеют, свой, собственного, собственное, собственной, собственном, собственную, собственным, собственными, собственных
russian - русский, по-русски, русского, России, на русском, российская, российских, российской, россиянин, россиянка, русская, русские, русский язык, русским, русских, русское, русской, русском, русскому, русскую
classes - курсы, занятий, занятия, класса, курсах, предметы, уроки, уроков
hamburger - гамбургер
sad - грустно, печальна, грустная, грустна, грустное, грустной, грустную, грустные, грустный, грустным, печален, печальная, печально, печальную, печальны, печальный
glad - рад, рады, рада
printer - принтер, принтере, принтера
grilled - жарил, пожарили
taking a picture - фотографирует, фотографируешь, фотографирую
wore - носил, носила, дорогую, она
носили
chinese - китайский, китаец, китайская, китайски, китайской, китайскому, китайскую, китайцев, китаянка, по-китайски
you - ты, вы, тебя, вам, вами, вас, им, к вам, себя, твоей, твоем, тебе, тобой, у вас, у тебя
statue of liberty - Статуя Свободы
this - это, этот, эта, в этом, в этот, на этой, на этом, об этом, по этому, эти, этим, этого, этой, этом, эту
flying - летят, летит, летать, летим, летишь, лечу
short - короткий, короткая, коротка, короткие, коротким, короткими, коротко, короткое, короткой, мала, мало, низкая, низкий, низким, низкой
nineteen eighty-five - 1985
most expensive - самом дорогом
hey - привет, слушай
more beautiful - красивее, красивей
late - поздно, опоздал, опоздали, опаздываем, опаздывает, опаздываешь, опаздывала, опаздывать, опоздаем, опоздала, опоздать, поздней, поздние
shorter - ниже, короче, более короткий, покороче
oldest - старший, старшая, самая старая, самое старое, самом старом, самый старый
cook - готовить, готовлю, повар, будешь готовить, варить, варю, готовил, готовим, готовит, готовите, готовишь, готовь, готовят, повара, поваром, повару, приготовим, приготовить, приготовлю, приготовят, свари, сварить
going to - буду, будем, собираемся, собирается, будут, идет на, едет, поеду в, будет, будете, собираюсь, собираешься, собираются, идет в, идем на
riding - едем, кататься, едет, едут, ездить, езжу
like - нравится, люблю, любят, как, как и, любил, любила, любим, любит, любите, любишь, например, нравилась, нравилось, нравятся, понравился, понравится, похож на, похожи на
professional - профессиональный, профессиональные, профессиональная, профессионал, профессионалов, профессионально, профессионального, профессиональное, профессиональны, профессиональным, профессиональными, профессиональных, специалист
grandparents - бабушку и дедушку, бабушкой и дедушкой, бабушка и дедушка, бабушки и дедушки, бабушке и дедушке
apple juice - яблочный сок, яблочного сока
countries - страны, странах, странами, стран, странам
baseball - бейсбол, бейсбольного
surfed - занимались сёрфингом, занимался сёрфингом, занималась сёрфингом, do not - не, нет
tooth - зубной, зуб
stopping - останавливаемся, останавливаешься, останавливаюсь
where are you from - откуда вы, откуда ты
october - октябре, октябрь, октября, октябрём
potatoes - картошку, картошка, картошки, картофелем, картофелин, картофелины, картофель, картофеля, картошек, картошкой
touch - трогать, трогаю, трогают, коснуться, потрогай, потрогать, прикоснуться, трогай, трогайте
boxes - коробок, коробки, коробках, коробками
true - настоящий, правдивы, правдива, верно, истинная, истинной, истинные, настоящая, настоящего, настоящим, правда, правдиво, правдивой, правдивые, правдой
carry-on - ручная кладь, ручной клади
its - свою, её, свой, его, ее, свое, своего, своей, свои, своим, своими, своих, своя, своё
wednesday - среду, среда, среды, в среду
moscow - Москве, Москву, Москвы, Москва, Москвой, московского, московском, московскому
wearing - носит, носить
she'll - она будет
она, married - женат, замужем, вышла замуж, вышла замуж за, женаты, женился, женился на, замужней, поженились
bag - сумка, сумке, сумку, (о) сумке, мешке, мешок, пакет, пакете, сумки, сумкой
italian - итальянский, итальянец, итальянка, итальянская, итальянски, итальянские, итальянским, итальянских, итальянского, итальянское, итальянской, итальянскую, по-итальянски
more romantic - романтичнее
cooked - готовил, готовили, готовила, приготовил, приготовила, приготовили
have a good - stays - остается
most - самый, наиболее, самое, больше всего, большинство, в большинстве, с самыми, самым, самыми
as well - хорошо, и, тоже
pink - розовые, розовая, розовый, розового, розовое, розовом, розовом цвете, розовую, розовыми, розовых
skating - кататься на коньках, покататься на коньках
now - сейчас, теперь
no problem - без проблем
hamburgers - гамбургеры, гамбургерами, гамбургера, thirteenth - тринадцатого, тринадцатое, тринадцатая
you're - ты, вы, будешь, тебе будет, ты будешь
what - что, то, что, какой, в каком, из какого, из чего, как, какая, какие, каким, каких, каков, какова, каково, каковы, какое, каком, какую, кого, кто, о чем, о чём, сколько, тем, чем, то, чего, чего, чем, что такое, чём
moscow - Москве, Москву, Москвы, Москва, Москвой, московского, московском, московскому
on sale - на распродаже
comfortable - удобная, удобный, удобных, комфортная, комфортной, комфортные, комфортный, удобное, удобные
fast - быстро, быстрая, быстрые, быстрой, быстрый, быстрым
straight - прямо, прямая, прямой, прямые, прямыми
america - Америке, Америку, Америка, Америки
teach - учить, преподаю, научить, обучает, обучаю, обучают, обучить, преподавать, преподаёте, учишь, учу
snake - змею, змея
enjoy your meal - приятного аппетита
two thousand two - 2002
either - любую, ни, любой, тоже
teaching - обучение, преподаванием, преподавать, обучает, обучаешь, обучаю, преподавание, учит, учить
eighteen - восемнадцать, восемнадцати, тысяча восемьсот (год)
luckily - к счастью
most - самый, наиболее, самое, больше всего, большинство, в большинстве, с самыми, самым, самыми
december - декабрь, декабря, декабре
make - делать, готовлю, делают, готовим, готовит, готовите, готовить, готовишь, делаем, делает, делаешь, делали, делаю, заключить, записаться, запишемся, запишись, заставить, изготавливаем, изготавливаю, изготавливают, осилить, приготовим, приготовить, принимают, принять, сделаем, сделай, сделала, сделать, создают, составь, справиться, убедись, чувствуй
thirty-five - visiting - навещу, навестит, посетить, навестим, навещал, посещать
slow down - помедленнее
long time ago - p.m. - вечера, дня, после полудня
dirty - грязные, грязный, грязная, будет грязной, грязно, грязное, грязной, грязную, грязным, грязными, грязных
third - в-третьих, третьем, третий, Третьей, треть, третье, третьего, третью, третья
meeting - собрание, встреча, встречаемся, встрече, встречи, встречу, познакомитесь, познакомитесь со, собранию
february - февраль, феврале, февраля
to sing - петь, пела
пели, eleven - одиннадцать, одиннадцати
watching - смотрим, смотреть, смотрю, наблюдать за, посмотреть, просмотр, просмотра, смотрит, смотришь
good luck - удачи
libraries - библиотеки, библиотек
run - бегаю, беги, бегать, (!) беги, (!) бегите, бегаем, бегает, бегаешь, бегай, бегайте, бегал, бегало, бегают, бегу, бегут, бежать, бежим, будете бегать, запускать, побегу, побежим, пробегать, пробегают, пробежал, пробежала, пробежали, пробежать, пробежку, убегаем
slowly - медленно
cupcake - пирожное
second - вторых, во-вторых, секунда, вторая, второго, второе, второй, второй (-ая, -ое, -ые), втором, секунду
how are you - как у тебя дела, как дела, как ты, как у вас дела
sixteen - шестнадцать, шестнадцати, от шестнадцати
wait for me - eighty - восемьдесят, восьмидесяти
relax - расслабься, расслабить, расслабиться, отдыхаем, отдыхаешь, отдыхают, отдохнуть, отдыхать, отдохните, отдыхай, отдыхаю
how old - сколько лет
lawyer - юрист, адвокат, адвоката, адвокатом, юриста, юристка, юристом
native language - correct - верно, правильно, правильный, верен, прав, права, правда, правильного, правильные
handsome - красивый, красивое, красивые, красивым, красивыми
that's - это
pet - домашнее животное, домашнего, домашние, домашний, домашнюю, домашняя, питомец
my - мой, моя, мои, в моей, в моём, за моего, к моим, мое, моего, моей, моем, моему, моим, моими, моих, мою, моё, моём, ни моей, свое, своего, своей, своем, своему, свои, своим, своими, своих, свой, свою, своя, своё, своём, у меня, у моего, у моей
perfect - идеальный, идеален, отлично, идеально, идеальной, идеальным, идеальными, превосходно, совершенен, совершенна, совершенное, совершенной, совершенный, совершенным
march - март, марта, мартом
bye - пока
brown - коричневый, коричневые, коричневая, бурого, буром, бурый, карие, карий, коричневого, коричневой, коричневом, коричневыми, коричневых
yet - ещё, ещё пока, всё же, всё-таки, ещё не, пока, пока ещё, уже
chose - выбрал, выбрала, выбрали
nineteen sixty - 1960
dog - собака, собаку, собаки, пёс, собаке, собакой, собачий
finally - наконец, наконец-то, наконец-таки, в конце концов
youngest - младший, младшая, самая молодая, самые молодые, самый молодой
check out - выселиться
english - английский, по-английски, английский язык, английская, английские, английским, английского, английской, английском, английскому, английскую, на английском
slippery - скользко
brazil - Бразилию, Бразилии, Бразилия
ok - хорошо, OK, в порядке, ладно, нормальная, нормально, нормальные, нормальный, нормальным
loved - любил, любила, любит, любили, любима, нравилась, нравились, нравилось, обожал, обожала, обожали, понравилась, понравились, понравилось, понравился
how many - сколько
stronger - сильнее, сильней
easy - легко, простой, простое, легкая, легкий, легким, легкими, легкое, легкой, лёгкая, лёгкий, лёгким, просто
tomato - помидор, томат, томатного, томатный
bus stop - thinner - худее
tonight - сегодня вечером, сегодня ночью, сегодняшнего, сегодняшнего вечера, сегодняшний вечер
taken out - выносила, вынес
cleaned - мыла, почистил, почистила, почистили, убирал, убирала, убирались, убирался, убрал, убрала, убрали, убран, чистила, чистыми
sing - поют, пою, поём, петь, поет, поёт, поёшь, спеть, споешь, спой
american - американец, американка, американский, американки, американская, американские, американским, американскими, американской, американскую, американца, американцем, американцу, американцы
both - оба, обе, обоих, обеими, обеих, обоим
delayed - задержался, отложили, отложил, задержали
strict - строгие, строгими, строгий, строгая
isn't it - не так ли
the united states - apple - яблоко, яблочный, яблока, яблоке, яблочное
fourteenth - четырнадцатого, четырнадцатом, четырнадцатое
appointment - встреча, встречи, встречу, прием
here's - вот
funnier - забавнее
to play - заниматься, чтобы играть, играть, поиграть
they'll - им, они
i bet - Спорим
especially - особенно
alone - одна, один, одинок, в одиночестве, одинока, одинокая, одиноки, одни, одному
done - сделал, сделано, сделана, готово, делал, делали, написали, сделала, сделали, сделанная, сделанное
having - нужно, иметь, едят, ешь, имеем, пить, устраивает, устроишь, что у неё есть
universities - университеты, университета
who - кто, кого, кому, за кем, за кого, кем, ком, которая, которой, которые, который, на кого, на ком, у кого
yours - твоя, твой, ваши, ваш, ваша, ваше, свою, твое, твоего, твоей, твои, твоим, твою, твоё
tiny - крошечном, крошечное, крошечной, крошечная, крошечную
raining - идёт дождь, дождь идет
abroad - за границей, за границу, за рубеж, за рубежом
health insurance - медицинская страховка, медицинской страховки, медицинскую страховку
anymore - больше, уже
nice to meet you - приятно познакомиться
eats - ест, съедает, кушает
helpful - полезный, полезной, готов помочь, полезные, готовы помочь
france - Франции, Францию, Франция
closed - закрылся, закрыт, закрылась, закрыл, закрыла, закрыли, закрыта, закрыто, закрыты
shelf - полке, полки, полка, полку
hasn't told - calendar - календарь, календаре, календаря, календарем
work - работе, работать, работаю, работа, работаем, работает, работаете, работаешь, работай, работайте, работал, работала, работали, работают, работой, работу, работы, рабочая, срабатывает
twenty-two - двадцать два года
renting - снимаете, арендуем, арендует, арендуешь
between - между, из, меж, от
swims - плавает, плывёт
seen - видел, видела, увидел, видал, видала, видели, замечена, замечены, проводил, увидела
my name is - меня зовут
brooklyn bridge - Бруклинский мост
spain - Испании, Испанию, Испания
where do you - break room - комната отдыха, в комнате отдыха
too many - happier - счастливее
reservation - бронь
try - попробуй, попробовать, пытайся, попробовал, попробовала, попробовали, попробуем, попробуйте, попытайся, попытайтесь, попыталась, попытались, попытался, попытаться, пробовать, пробуем, пробуй, пробую, пробуют, пытаешься, пытаться, пытаюсь, пытаются, стараюсь, стараются
away - прочь, вдали, в отъезде, отсюда
karaoke - караоке, в караоке
traveled - ездили, проехали, ехали, ездила, ездил, поехали, поехала
map - карта, карте, карту, карты
sport - спорт, спорта, спортом, спорт, который, спорт, которым
has played - играл, сыграл, играла
st. petersburg - Санкт-Петербурге, Санкт-Петербург, Санкт-Петербурга
surf - заниматься сёрфингом, занимаюсь сёрфингом
left - налево, левой, осталось, вышедших, вышел, вышли, забыл, забыла, левая, левого, левое, левом, левую, левые, левый, оставил, оставила, оставили, оставлена, оставленным, осталась, остался, покинул, покинула, покинули, уехал, уехала, уехали, улетал, улетел, улетела, ушел, ушла, ушли, ушёл
under - под, подо, при, до, меньше
mexican - мексиканец, мексиканские, мексиканской, мексиканская, мексиканскую
beautiful - красивая, красива, красивый, красиво, красивого, красивое, красивом, красивую, красивые, красивым, красивыми, прекрасен, прекрасна, прекрасная, прекрасно, прекрасное, прекрасны, прекрасные, прекрасный
past - мимо, прошлый, прошлая, прошлое
fitting room - примерочная, примерочной
ready - готов, готова, готово, будете готовы, готовы, готовым
there were - было, были
july - июле, июля, июль
safer - безопасней, безопаснее
americans - американцы, американцев, американцам, американцами
fifth - пятого, пятом, пятая, пятый
boston - Бостон, Бостона, Бостоне, Бостоном, в Бостоне
biggest - самое большое, самую большую, самая большая, самые большие
preferred - предпочитали, предпочитал
hasn't returned - talented - талантливая, талантливые, талантливый, одарённый, талантливым, талантливыми, талантливых
swim - плавать, плавают, плаваем, (!) плыви, (!) плывите, искупаемся, искупайся, искупаюсь, плавает, плаваете, плаваешь, плавай, плавайте, плаваю, плыву, плывут, плывём, плывёт, плыть, поплаваем, поплывёт, проплывают
mexico - Мексике, Мексика, Мексику, Мексики, those - те, теми, тем, тех, то, ту, эти, это
keys - ключи, клавиши, клавиш, ключа
glass of - learning - учусь, учится, изучает, изучаешь, изучать, изучаю, изучение, изучении, учит
delicious - вкусный, вкусное, вкусные, вкусная, вкусно, вкусных, очень вкусный
above - над
busiest - самое оживленное, самый оживленный, самой оживленной
sings - поёт, поет, споет
thrillers - триллеры, триллерах, триллеров
foot - нога, ногу, ступней, ступню, ступня
travel - путешествовать, езжу, путешествуют, едем, ездим, ездите, ездить, ездишь, ездят, ехать, поедем, поезжай, поехал, поехали, поехать, путешествуем, путешествую
has danced - потанцевал, танцевал, танцевала
has tried - пробовал, попробовал, пробовала, попробовала
traffic - транспорта, трафика, пробка, пробками, пробки, транспорт
chair - стул, стуле, стулом, кресла, кресле, кресло, стула
got - арестовали, получал, получала, получил, получила, получили, попали, пришло, сели, стал, стали
cheers - За здоровье, за твое здоровье
за ваше здоровье, safe - цел, безопасен, безопасная, безопасном, безопасные, безопасный, безопасным
jazz - джаз
bottle of - бутылку, бутылка
well - хорошо, известны, колодец, ну
snowing - снег идет
fishing - рыбалка, рыбалку
stopped - остановил, остановился, перестал, останавливались, остановилась, остановились, остановилось, перестала, перестали, прекратил, прекратила, прекратили
outside - на улице, возле, за, на улицу, снаружи
new york - Нью-Йорк, Нью-Йорке, Нью-Йорка
Нью-Йорком
have never - ran - побежал, бегал, бежал, бегала, бегали, бежала, бежали, побежала, побежали, пробежал, пробежала, пробежали, сбежал
girlfriend - девушка, девушку, девушки, девушке, девушкой, подруга, подружка
impossible - невозможно, невозможным, невозможна, невозможной
what time - в котором часу, во сколько
parties - вечеринки, вечеринками, партий, вечеринках
dramas - драмы
comedies - комедии
roommates - соседями по квартире, соседи, соседей по квартире, соседи по квартире
last name - фамилия, фамилию, фамилии
first name - имя
passport - паспорт, паспорте, паспортом
visa - виза
